"County","Year","Age Range","White","Black","American Indian","Asian","Total"
"Big Horn",2013,"0","131","4","2","0","137"
"Big Horn",2013,"1","141","0","2","0","143"
"Big Horn",2013,"2","159","1","1","2","163"
"Big Horn",2013,"3","148","2","5","0","155"
"Big Horn",2013,"4","151","1","3","0","155"
"Big Horn",2013,"5","158","2","0","0","160"
"Big Horn",2013,"6","160","3","1","0","164"
"Big Horn",2013,"7","171","0","2","2","175"
"Big Horn",2013,"8","185","1","0","1","187"
"Big Horn",2013,"9","154","4","0","3","161"
"Big Horn",2013,"10","168","0","2","2","172"
"Big Horn",2013,"11","161","3","0","0","164"
"Big Horn",2013,"12","163","1","3","3","170"
"Big Horn",2013,"13","172","2","4","2","180"
"Big Horn",2013,"14","156","3","1","0","160"
"Big Horn",2013,"15","183","2","0","2","187"
"Big Horn",2013,"16","188","3","0","2","193"
"Big Horn",2013,"17","180","7","2","1","190"
"Big Horn",2013,"18 to 20","410","18","6","3","437"
"Big Horn",2013,"21 to 24","464","17","15","5","501"
"Big Horn",2013,"25 & over","7751","120","117","37","8025"
"Big Horn",2013,"Total","11554","194","166","65","11979"
"Laramie",2004,"0","1143","85","22","15","1265"
"Laramie",2004,"1","1090","61","15","17","1183"
"Laramie",2004,"2","1076","73","29","25","1203"
"Laramie",2004,"3","1000","74","20","21","1115"
"Laramie",2004,"4","993","74","15","17","1099"
"Laramie",2004,"5","1030","42","13","21","1106"
"Laramie",2004,"6","1006","55","20","21","1102"
"Laramie",2004,"7","1021","37","18","10","1086"
"Laramie",2004,"8","981","38","23","17","1059"
"Laramie",2004,"9","1046","55","14","13","1128"
"Laramie",2004,"10","1141","48","27","16","1232"
"Laramie",2004,"11","1216","55","28","24","1323"
"Laramie",2004,"12","1098","54","18","8","1178"
"Laramie",2004,"13","1179","44","11","15","1249"
"Laramie",2004,"14","1155","33","19","18","1225"
"Laramie",2004,"15","1142","48","20","11","1221"
"Laramie",2004,"16","1093","40","19","20","1172"
"Laramie",2004,"17","1134","26","14","19","1193"
"Laramie",2004,"18 to 20","3547","250","67","55","3919"
"Laramie",2004,"21 to 24","4748","321","96","95","5260"
"Laramie",2004,"25 & over","52579","1247","591","692","55109"
"Laramie",2004,"Total","80418","2760","1099","1150","85427"
"Campbell",2003,"0","537","5","13","3","558"
"Campbell",2003,"1","495","6","18","7","526"
"Campbell",2003,"2","524","6","17","2","549"
"Campbell",2003,"3","553","6","14","1","574"
"Campbell",2003,"4","551","5","8","4","568"
"Campbell",2003,"5","595","3","7","0","605"
"Campbell",2003,"6","531","6","9","3","549"
"Campbell",2003,"7","531","6","8","3","548"
"Campbell",2003,"8","514","5","6","3","528"
"Campbell",2003,"9","577","5","9","3","594"
"Campbell",2003,"10","574","4","12","4","594"
"Campbell",2003,"11","585","2","10","5","602"
"Campbell",2003,"12","636","5","7","2","650"
"Campbell",2003,"13","610","3","17","1","631"
"Campbell",2003,"14","608","6","8","2","624"
"Campbell",2003,"15","622","2","11","2","637"
"Campbell",2003,"16","672","2","10","3","687"
"Campbell",2003,"17","662","4","10","4","680"
"Campbell",2003,"18 to 20","1594","14","27","8","1643"
"Campbell",2003,"21 to 24","2097","9","41","14","2161"
"Campbell",2003,"25 & over","21668","55","232","123","22078"
"Campbell",2003,"Total","35736","159","494","197","36586"
"Carbon",2012,"0","186","1","2","0","189"
"Carbon",2012,"1","197","5","4","4","210"
"Carbon",2012,"2","191","3","4","1","199"
"Carbon",2012,"3","216","2","2","0","220"
"Carbon",2012,"4","206","3","2","3","214"
"Carbon",2012,"5","215","1","3","3","222"
"Carbon",2012,"6","189","5","2","2","198"
"Carbon",2012,"7","181","4","6","3","194"
"Carbon",2012,"8","200","4","0","2","206"
"Carbon",2012,"9","198","4","3","1","206"
"Carbon",2012,"10","179","2","4","2","187"
"Carbon",2012,"11","191","4","7","2","204"
"Carbon",2012,"12","191","5","4","1","201"
"Carbon",2012,"13","200","1","5","2","208"
"Carbon",2012,"14","187","2","3","1","193"
"Carbon",2012,"15","186","1","3","2","192"
"Carbon",2012,"16","172","1","4","2","179"
"Carbon",2012,"17","174","2","5","2","183"
"Carbon",2012,"18 to 20","460","18","13","5","496"
"Carbon",2012,"21 to 24","729","18","20","18","785"
"Carbon",2012,"25 & over","10338","175","181","101","10795"
"Carbon",2012,"Total","14986","261","277","157","15681"
"Hot Springs",1993,"0","48","0","0","0","48"
"Hot Springs",1993,"1","39","0","1","0","40"
"Hot Springs",1993,"2","41","0","7","0","48"
"Hot Springs",1993,"3","48","0","0","0","48"
"Hot Springs",1993,"4","48","0","1","0","49"
"Hot Springs",1993,"5","51","0","2","0","53"
"Hot Springs",1993,"6","54","0","4","0","58"
"Hot Springs",1993,"7","55","0","1","0","56"
"Hot Springs",1993,"8","62","0","4","0","66"
"Hot Springs",1993,"9","79","0","1","0","80"
"Hot Springs",1993,"10","75","0","2","0","77"
"Hot Springs",1993,"11","74","0","2","0","76"
"Hot Springs",1993,"12","83","0","5","0","88"
"Hot Springs",1993,"13","83","0","1","0","84"
"Hot Springs",1993,"14","90","0","4","0","94"
"Hot Springs",1993,"15","72","0","3","0","75"
"Hot Springs",1993,"16","77","0","2","0","79"
"Hot Springs",1993,"17","76","0","2","0","78"
"Hot Springs",1993,"18 to 20","131","1","2","0","134"
"Hot Springs",1993,"21 to 24","120","0","1","0","121"
"Hot Springs",1993,"25 & over","3256","0","42","0","3298"
"Hot Springs",1993,"Total","4662","1","87","0","4750"
"Converse",1999,"0","151","0","0","0","151"
"Converse",1999,"1","132","2","6","0","140"
"Converse",1999,"2","141","4","0","0","145"
"Converse",1999,"3","167","0","0","0","167"
"Converse",1999,"4","170","0","4","0","174"
"Converse",1999,"5","176","2","2","1","181"
"Converse",1999,"6","151","0","0","0","151"
"Converse",1999,"7","185","4","4","0","193"
"Converse",1999,"8","192","0","0","0","192"
"Converse",1999,"9","204","0","5","1","210"
"Converse",1999,"10","183","0","0","2","185"
"Converse",1999,"11","184","0","4","0","188"
"Converse",1999,"12","203","0","2","0","205"
"Converse",1999,"13","231","0","0","0","231"
"Converse",1999,"14","235","8","8","1","252"
"Converse",1999,"15","227","2","0","3","232"
"Converse",1999,"16","227","0","3","0","230"
"Converse",1999,"17","261","0","2","0","263"
"Converse",1999,"18 to 20","401","0","6","0","407"
"Converse",1999,"21 to 24","432","0","3","0","435"
"Converse",1999,"25 & over","7586","4","59","12","7661"
"Converse",1999,"Total","11839","26","108","20","11993"
"Goshen",2012,"0","130","2","5","0","137"
"Goshen",2012,"1","104","4","3","0","111"
"Goshen",2012,"2","150","3","3","1","157"
"Goshen",2012,"3","146","2","3","2","153"
"Goshen",2012,"4","138","4","0","3","145"
"Goshen",2012,"5","160","2","4","0","166"
"Goshen",2012,"6","127","1","4","1","133"
"Goshen",2012,"7","122","1","0","0","123"
"Goshen",2012,"8","137","1","0","2","140"
"Goshen",2012,"9","137","0","3","2","142"
"Goshen",2012,"10","146","1","1","1","149"
"Goshen",2012,"11","157","2","2","1","162"
"Goshen",2012,"12","170","2","2","1","175"
"Goshen",2012,"13","150","0","0","2","152"
"Goshen",2012,"14","165","2","4","1","172"
"Goshen",2012,"15","170","3","2","2","177"
"Goshen",2012,"16","155","3","2","1","161"
"Goshen",2012,"17","143","3","3","0","149"
"Goshen",2012,"18 to 20","636","21","11","5","673"
"Goshen",2012,"21 to 24","761","20","11","4","796"
"Goshen",2012,"25 & over","9247","107","82","47","9483"
"Goshen",2012,"Total","13251","184","145","76","13656"
"Johnson",2014,"0","92","0","4","1","97"
"Johnson",2014,"1","89","0","8","1","98"
"Johnson",2014,"2","89","3","3","2","97"
"Johnson",2014,"3","107","6","9","1","123"
"Johnson",2014,"4","90","1","10","5","106"
"Johnson",2014,"5","111","1","6","2","120"
"Johnson",2014,"6","108","1","5","4","118"
"Johnson",2014,"7","110","1","3","1","115"
"Johnson",2014,"8","106","1","6","0","113"
"Johnson",2014,"9","121","0","2","1","124"
"Johnson",2014,"10","105","2","3","0","110"
"Johnson",2014,"11","78","2","3","0","83"
"Johnson",2014,"12","97","1","2","0","100"
"Johnson",2014,"13","94","1","1","0","96"
"Johnson",2014,"14","87","2","2","0","91"
"Johnson",2014,"15","93","0","2","0","95"
"Johnson",2014,"16","103","0","1","0","104"
"Johnson",2014,"17","100","2","2","1","105"
"Johnson",2014,"18 to 20","267","4","5","1","277"
"Johnson",2014,"21 to 24","279","5","9","4","297"
"Johnson",2014,"25 & over","5921","64","53","55","6093"
"Johnson",2014,"Total","8247","97","139","79","8562"
"Fremont",2011,"0","343","9","273","5","630"
"Fremont",2011,"1","385","6","244","6","641"
"Fremont",2011,"2","392","5","214","2","613"
"Fremont",2011,"3","383","6","237","3","629"
"Fremont",2011,"4","408","6","210","3","627"
"Fremont",2011,"5","391","2","250","2","645"
"Fremont",2011,"6","381","4","231","3","619"
"Fremont",2011,"7","362","5","226","4","597"
"Fremont",2011,"8","353","5","217","3","578"
"Fremont",2011,"9","356","5","200","2","563"
"Fremont",2011,"10","357","7","181","2","547"
"Fremont",2011,"11","345","5","166","0","516"
"Fremont",2011,"12","339","6","174","1","520"
"Fremont",2011,"13","361","5","177","3","546"
"Fremont",2011,"14","355","4","171","5","535"
"Fremont",2011,"15","353","3","172","3","531"
"Fremont",2011,"16","330","3","157","2","492"
"Fremont",2011,"17","364","3","166","4","537"
"Fremont",2011,"18 to 20","1043","7","486","4","1540"
"Fremont",2011,"21 to 24","1375","15","572","11","1973"
"Fremont",2011,"25 & over","21980","99","4503","134","26716"
"Fremont",2011,"Total","30956","210","9227","202","40595"
"Niobrara",2006,"0","21","1","0","0","22"
"Niobrara",2006,"1","15","0","0","0","15"
"Niobrara",2006,"2","10","0","0","0","10"
"Niobrara",2006,"3","26","0","0","0","26"
"Niobrara",2006,"4","14","0","1","0","15"
"Niobrara",2006,"5","21","0","0","0","21"
"Niobrara",2006,"6","14","0","0","0","14"
"Niobrara",2006,"7","29","0","0","0","29"
"Niobrara",2006,"8","16","0","0","0","16"
"Niobrara",2006,"9","41","0","0","0","41"
"Niobrara",2006,"10","19","0","0","0","19"
"Niobrara",2006,"11","28","0","0","0","28"
"Niobrara",2006,"12","19","1","0","0","20"
"Niobrara",2006,"13","27","0","0","0","27"
"Niobrara",2006,"14","25","0","0","1","26"
"Niobrara",2006,"15","36","0","0","0","36"
"Niobrara",2006,"16","31","0","0","0","31"
"Niobrara",2006,"17","41","0","0","1","42"
"Niobrara",2006,"18 to 20","50","0","0","0","50"
"Niobrara",2006,"21 to 24","97","1","2","0","100"
"Niobrara",2006,"25 & over","1708","5","16","4","1733"
"Niobrara",2006,"Total","2288","8","19","6","2321"
"Johnson",2013,"0","93","0","8","1","102"
"Johnson",2013,"1","92","3","3","2","100"
"Johnson",2013,"2","108","3","9","0","120"
"Johnson",2013,"3","90","0","10","5","105"
"Johnson",2013,"4","115","2","6","3","126"
"Johnson",2013,"5","109","1","5","4","119"
"Johnson",2013,"6","117","2","3","1","123"
"Johnson",2013,"7","110","3","5","1","119"
"Johnson",2013,"8","122","1","2","1","126"
"Johnson",2013,"9","104","0","3","0","107"
"Johnson",2013,"10","87","0","3","0","90"
"Johnson",2013,"11","99","1","2","0","102"
"Johnson",2013,"12","84","1","1","0","86"
"Johnson",2013,"13","94","1","2","0","97"
"Johnson",2013,"14","90","1","2","0","93"
"Johnson",2013,"15","105","0","1","0","106"
"Johnson",2013,"16","98","1","1","1","101"
"Johnson",2013,"17","97","0","0","0","97"
"Johnson",2013,"18 to 20","260","9","6","1","276"
"Johnson",2013,"21 to 24","261","5","9","6","281"
"Johnson",2013,"25 & over","5968","69","56","50","6143"
"Johnson",2013,"Total","8303","103","137","76","8619"
"Johnson",2005,"0","88","0","4","0","92"
"Johnson",2005,"1","87","1","2","1","91"
"Johnson",2005,"2","61","0","2","0","63"
"Johnson",2005,"3","68","1","2","0","71"
"Johnson",2005,"4","89","2","2","0","93"
"Johnson",2005,"5","77","0","3","1","81"
"Johnson",2005,"6","86","1","2","0","89"
"Johnson",2005,"7","86","0","1","0","87"
"Johnson",2005,"8","90","0","0","0","90"
"Johnson",2005,"9","73","0","1","0","74"
"Johnson",2005,"10","118","1","1","0","120"
"Johnson",2005,"11","91","0","1","0","92"
"Johnson",2005,"12","108","0","1","0","109"
"Johnson",2005,"13","105","0","0","0","105"
"Johnson",2005,"14","102","1","2","0","105"
"Johnson",2005,"15","125","2","1","0","128"
"Johnson",2005,"16","99","2","1","1","103"
"Johnson",2005,"17","103","0","0","0","103"
"Johnson",2005,"18 to 20","228","0","4","2","234"
"Johnson",2005,"21 to 24","270","2","5","3","280"
"Johnson",2005,"25 & over","5420","8","36","11","5475"
"Johnson",2005,"Total","7574","21","71","19","7685"
"Niobrara",1995,"0","21","0","0","0","21"
"Niobrara",1995,"1","26","0","0","0","26"
"Niobrara",1995,"2","25","0","0","0","25"
"Niobrara",1995,"3","31","0","0","0","31"
"Niobrara",1995,"4","23","0","0","0","23"
"Niobrara",1995,"5","30","0","0","0","30"
"Niobrara",1995,"6","25","0","0","0","25"
"Niobrara",1995,"7","39","0","0","0","39"
"Niobrara",1995,"8","30","0","0","0","30"
"Niobrara",1995,"9","32","0","0","0","32"
"Niobrara",1995,"10","35","0","0","0","35"
"Niobrara",1995,"11","37","0","0","0","37"
"Niobrara",1995,"12","37","0","0","0","37"
"Niobrara",1995,"13","44","0","0","0","44"
"Niobrara",1995,"14","41","0","0","0","41"
"Niobrara",1995,"15","44","0","0","0","44"
"Niobrara",1995,"16","35","0","0","0","35"
"Niobrara",1995,"17","37","0","0","0","37"
"Niobrara",1995,"18 to 20","73","1","0","0","74"
"Niobrara",1995,"21 to 24","62","0","0","0","62"
"Niobrara",1995,"25 & over","1751","1","3","0","1755"
"Niobrara",1995,"Total","2478","2","3","0","2483"
"Converse",2013,"0","178","3","5","0","186"
"Converse",2013,"1","217","4","6","0","227"
"Converse",2013,"2","166","4","6","0","176"
"Converse",2013,"3","200","2","4","1","207"
"Converse",2013,"4","205","4","2","1","212"
"Converse",2013,"5","184","4","2","0","190"
"Converse",2013,"6","201","3","2","2","208"
"Converse",2013,"7","202","3","5","2","212"
"Converse",2013,"8","214","4","3","1","222"
"Converse",2013,"9","187","4","4","0","195"
"Converse",2013,"10","176","1","5","1","183"
"Converse",2013,"11","188","3","7","1","199"
"Converse",2013,"12","202","2","1","2","207"
"Converse",2013,"13","201","0","2","5","208"
"Converse",2013,"14","202","5","5","1","213"
"Converse",2013,"15","180","2","3","0","185"
"Converse",2013,"16","181","4","3","1","189"
"Converse",2013,"17","198","6","2","0","206"
"Converse",2013,"18 to 20","457","14","6","1","478"
"Converse",2013,"21 to 24","659","9","11","3","682"
"Converse",2013,"25 & over","9288","121","114","50","9573"
"Converse",2013,"Total","13886","202","198","72","14358"
"Washakie",2002,"0","82","0","0","2","84"
"Washakie",2002,"1","94","1","1","1","97"
"Washakie",2002,"2","82","0","2","2","86"
"Washakie",2002,"3","107","1","0","0","108"
"Washakie",2002,"4","108","1","1","0","110"
"Washakie",2002,"5","93","1","2","2","98"
"Washakie",2002,"6","93","2","1","1","97"
"Washakie",2002,"7","93","0","1","2","96"
"Washakie",2002,"8","87","1","1","0","89"
"Washakie",2002,"9","91","2","1","3","97"
"Washakie",2002,"10","119","0","0","0","119"
"Washakie",2002,"11","112","0","1","0","113"
"Washakie",2002,"12","141","0","3","1","145"
"Washakie",2002,"13","120","1","1","3","125"
"Washakie",2002,"14","121","0","4","1","126"
"Washakie",2002,"15","140","0","1","1","142"
"Washakie",2002,"16","162","3","3","0","168"
"Washakie",2002,"17","145","1","3","1","150"
"Washakie",2002,"18 to 20","299","2","4","1","306"
"Washakie",2002,"21 to 24","271","1","0","3","275"
"Washakie",2002,"25 & over","5275","6","35","41","5357"
"Washakie",2002,"Total","7835","23","65","65","7988"
"Platte",1990,"0","114","0","0","0","114"
"Platte",1990,"1","110","0","1","0","111"
"Platte",1990,"2","113","0","0","0","113"
"Platte",1990,"3","111","0","0","0","111"
"Platte",1990,"4","141","0","1","0","142"
"Platte",1990,"5","142","1","1","1","145"
"Platte",1990,"6","132","0","0","0","132"
"Platte",1990,"7","126","0","0","0","126"
"Platte",1990,"8","145","0","0","0","145"
"Platte",1990,"9","127","0","0","0","127"
"Platte",1990,"10","142","1","0","0","143"
"Platte",1990,"11","153","0","1","0","154"
"Platte",1990,"12","132","0","0","0","132"
"Platte",1990,"13","129","0","0","0","129"
"Platte",1990,"14","129","0","0","0","129"
"Platte",1990,"15","141","0","0","0","141"
"Platte",1990,"16","128","0","0","0","128"
"Platte",1990,"17","126","0","0","0","126"
"Platte",1990,"18 to 20","239","0","0","2","241"
"Platte",1990,"21 to 24","270","0","0","0","270"
"Platte",1990,"25 & over","5244","0","9","1","5254"
"Platte",1990,"Total","8094","2","13","4","8113"
"Carbon",1994,"0","179","0","0","1","180"
"Carbon",1994,"1","196","0","6","0","202"
"Carbon",1994,"2","194","4","0","0","198"
"Carbon",1994,"3","191","0","4","0","195"
"Carbon",1994,"4","216","0","0","0","216"
"Carbon",1994,"5","222","4","9","0","235"
"Carbon",1994,"6","219","0","1","0","220"
"Carbon",1994,"7","227","0","0","2","229"
"Carbon",1994,"8","227","2","9","2","240"
"Carbon",1994,"9","242","0","0","3","245"
"Carbon",1994,"10","262","4","4","4","274"
"Carbon",1994,"11","274","3","7","0","284"
"Carbon",1994,"12","293","4","0","1","298"
"Carbon",1994,"13","285","0","0","0","285"
"Carbon",1994,"14","307","0","0","4","311"
"Carbon",1994,"15","275","1","0","4","280"
"Carbon",1994,"16","277","0","0","0","277"
"Carbon",1994,"17","290","0","1","3","294"
"Carbon",1994,"18 to 20","546","5","11","3","565"
"Carbon",1994,"21 to 24","709","4","10","6","729"
"Carbon",1994,"25 & over","10210","57","86","40","10393"
"Carbon",1994,"Total","15841","88","148","73","16150"
"Washakie",1990,"0","118","0","0","1","119"
"Washakie",1990,"1","106","0","2","0","108"
"Washakie",1990,"2","119","0","0","3","122"
"Washakie",1990,"3","114","0","0","0","114"
"Washakie",1990,"4","124","0","0","0","124"
"Washakie",1990,"5","130","1","4","2","137"
"Washakie",1990,"6","131","0","0","1","132"
"Washakie",1990,"7","141","0","0","0","141"
"Washakie",1990,"8","154","0","0","0","154"
"Washakie",1990,"9","175","0","0","0","175"
"Washakie",1990,"10","165","0","0","1","166"
"Washakie",1990,"11","169","0","0","0","169"
"Washakie",1990,"12","133","0","3","1","137"
"Washakie",1990,"13","152","0","2","0","154"
"Washakie",1990,"14","147","0","1","0","148"
"Washakie",1990,"15","171","0","4","0","175"
"Washakie",1990,"16","133","0","0","0","133"
"Washakie",1990,"17","134","0","0","2","136"
"Washakie",1990,"18 to 20","259","1","1","0","261"
"Washakie",1990,"21 to 24","265","0","0","0","265"
"Washakie",1990,"25 & over","5255","1","18","19","5293"
"Washakie",1990,"Total","8295","3","35","30","8363"
"Johnson",2009,"0","105","0","6","1","112"
"Johnson",2009,"1","122","1","4","1","128"
"Johnson",2009,"2","109","0","4","0","113"
"Johnson",2009,"3","110","1","2","0","113"
"Johnson",2009,"4","116","3","3","0","122"
"Johnson",2009,"5","120","0","2","2","124"
"Johnson",2009,"6","71","1","1","0","73"
"Johnson",2009,"7","89","0","2","0","91"
"Johnson",2009,"8","96","0","0","0","96"
"Johnson",2009,"9","86","0","0","0","86"
"Johnson",2009,"10","93","1","1","0","95"
"Johnson",2009,"11","94","0","1","0","95"
"Johnson",2009,"12","103","0","1","0","104"
"Johnson",2009,"13","90","0","0","1","91"
"Johnson",2009,"14","116","1","0","0","117"
"Johnson",2009,"15","116","2","1","0","119"
"Johnson",2009,"16","115","2","4","2","123"
"Johnson",2009,"17","100","1","0","0","101"
"Johnson",2009,"18 to 20","211","0","5","2","218"
"Johnson",2009,"21 to 24","291","1","8","3","303"
"Johnson",2009,"25 & over","6052","12","50","27","6141"
"Johnson",2009,"Total","8405","26","95","39","8565"
"Weston",2000,"0","55","0","2","0","57"
"Weston",2000,"1","75","1","3","0","79"
"Weston",2000,"2","66","0","3","0","69"
"Weston",2000,"3","77","0","1","0","78"
"Weston",2000,"4","61","0","2","0","63"
"Weston",2000,"5","54","0","0","0","54"
"Weston",2000,"6","74","0","2","1","77"
"Weston",2000,"7","76","0","0","0","76"
"Weston",2000,"8","70","0","1","1","72"
"Weston",2000,"9","72","0","2","0","74"
"Weston",2000,"10","88","0","1","0","89"
"Weston",2000,"11","104","1","2","1","108"
"Weston",2000,"12","89","1","0","0","90"
"Weston",2000,"13","117","0","0","1","118"
"Weston",2000,"14","101","0","2","0","103"
"Weston",2000,"15","124","0","1","0","125"
"Weston",2000,"16","126","0","1","0","127"
"Weston",2000,"17","128","1","2","0","131"
"Weston",2000,"18 to 20","248","0","14","0","262"
"Weston",2000,"21 to 24","217","1","7","0","225"
"Weston",2000,"25 & over","4492","4","43","11","4550"
"Weston",2000,"Total","6514","9","89","15","6627"
"Weston",1993,"0","66","0","2","0","68"
"Weston",1993,"1","78","0","0","0","78"
"Weston",1993,"2","82","0","3","0","85"
"Weston",1993,"3","84","0","1","0","85"
"Weston",1993,"4","85","0","2","0","87"
"Weston",1993,"5","87","0","0","0","87"
"Weston",1993,"6","92","0","0","0","92"
"Weston",1993,"7","104","0","0","0","104"
"Weston",1993,"8","106","0","0","0","106"
"Weston",1993,"9","114","0","5","0","119"
"Weston",1993,"10","119","0","5","0","124"
"Weston",1993,"11","134","0","1","0","135"
"Weston",1993,"12","119","0","0","0","119"
"Weston",1993,"13","138","0","0","0","138"
"Weston",1993,"14","112","0","0","0","112"
"Weston",1993,"15","127","0","0","0","127"
"Weston",1993,"16","102","0","0","0","102"
"Weston",1993,"17","97","0","2","0","99"
"Weston",1993,"18 to 20","210","0","13","0","223"
"Weston",1993,"21 to 24","223","0","6","0","229"
"Weston",1993,"25 & over","4238","0","26","4","4268"
"Weston",1993,"Total","6517","0","66","4","6587"
"Uinta",1995,"0","324","1","1","0","326"
"Uinta",1995,"1","352","2","2","2","358"
"Uinta",1995,"2","329","0","2","0","331"
"Uinta",1995,"3","326","0","0","3","329"
"Uinta",1995,"4","365","2","2","3","372"
"Uinta",1995,"5","360","6","3","1","370"
"Uinta",1995,"6","396","3","1","3","403"
"Uinta",1995,"7","360","0","6","3","369"
"Uinta",1995,"8","376","2","1","0","379"
"Uinta",1995,"9","403","0","2","3","408"
"Uinta",1995,"10","455","4","6","5","470"
"Uinta",1995,"11","429","0","4","0","433"
"Uinta",1995,"12","475","0","4","0","479"
"Uinta",1995,"13","474","0","4","2","480"
"Uinta",1995,"14","473","0","5","0","478"
"Uinta",1995,"15","461","1","4","0","466"
"Uinta",1995,"16","465","0","4","3","472"
"Uinta",1995,"17","425","0","3","1","429"
"Uinta",1995,"18 to 20","789","0","4","6","799"
"Uinta",1995,"21 to 24","829","0","12","0","841"
"Uinta",1995,"25 & over","10794","5","66","27","10892"
"Uinta",1995,"Total","19660","26","136","62","19884"
"Sweetwater",2008,"0","655","16","32","5","708"
"Sweetwater",2008,"1","711","14","14","7","746"
"Sweetwater",2008,"2","689","18","12","4","723"
"Sweetwater",2008,"3","594","13","8","4","619"
"Sweetwater",2008,"4","620","16","13","10","659"
"Sweetwater",2008,"5","673","14","12","5","704"
"Sweetwater",2008,"6","624","6","17","8","655"
"Sweetwater",2008,"7","562","18","16","8","604"
"Sweetwater",2008,"8","567","11","3","9","590"
"Sweetwater",2008,"9","578","9","5","10","602"
"Sweetwater",2008,"10","607","8","18","3","636"
"Sweetwater",2008,"11","590","11","15","5","621"
"Sweetwater",2008,"12","529","10","7","5","551"
"Sweetwater",2008,"13","536","14","8","6","564"
"Sweetwater",2008,"14","561","14","11","9","595"
"Sweetwater",2008,"15","556","12","7","5","580"
"Sweetwater",2008,"16","603","7","10","5","625"
"Sweetwater",2008,"17","594","8","18","10","630"
"Sweetwater",2008,"18 to 20","1676","32","30","21","1759"
"Sweetwater",2008,"21 to 24","2596","52","38","38","2724"
"Sweetwater",2008,"25 & over","25624","294","298","247","26463"
"Sweetwater",2008,"Total","40745","597","592","424","42358"
"Johnson",2007,"0","105","0","6","1","112"
"Johnson",2007,"1","96","1","3","0","100"
"Johnson",2007,"2","93","0","3","0","96"
"Johnson",2007,"3","104","1","2","0","107"
"Johnson",2007,"4","69","2","2","0","73"
"Johnson",2007,"5","85","0","2","2","89"
"Johnson",2007,"6","85","1","3","0","89"
"Johnson",2007,"7","91","0","1","0","92"
"Johnson",2007,"8","77","0","0","0","77"
"Johnson",2007,"9","80","0","1","0","81"
"Johnson",2007,"10","99","1","1","0","101"
"Johnson",2007,"11","83","0","1","0","84"
"Johnson",2007,"12","125","0","1","0","126"
"Johnson",2007,"13","103","0","0","1","104"
"Johnson",2007,"14","111","1","0","0","112"
"Johnson",2007,"15","120","2","1","0","123"
"Johnson",2007,"16","106","2","3","2","113"
"Johnson",2007,"17","120","1","0","0","121"
"Johnson",2007,"18 to 20","208","0","5","2","215"
"Johnson",2007,"21 to 24","315","1","5","3","324"
"Johnson",2007,"25 & over","5725","13","47","22","5807"
"Johnson",2007,"Total","8000","26","87","33","8146"
"Campbell",1994,"0","450","0","5","2","457"
"Campbell",1994,"1","484","2","11","2","499"
"Campbell",1994,"2","509","2","6","0","517"
"Campbell",1994,"3","491","0","8","0","499"
"Campbell",1994,"4","539","2","6","0","547"
"Campbell",1994,"5","539","0","11","0","550"
"Campbell",1994,"6","553","0","6","1","560"
"Campbell",1994,"7","563","0","8","0","571"
"Campbell",1994,"8","571","3","5","1","580"
"Campbell",1994,"9","625","0","12","7","644"
"Campbell",1994,"10","619","5","10","6","640"
"Campbell",1994,"11","628","0","10","0","638"
"Campbell",1994,"12","674","0","15","4","693"
"Campbell",1994,"13","657","0","15","3","675"
"Campbell",1994,"14","664","0","7","0","671"
"Campbell",1994,"15","635","1","8","4","648"
"Campbell",1994,"16","597","2","7","1","607"
"Campbell",1994,"17","579","1","10","3","593"
"Campbell",1994,"18 to 20","1141","1","11","0","1153"
"Campbell",1994,"21 to 24","1376","3","31","9","1419"
"Campbell",1994,"25 & over","17461","15","148","50","17674"
"Campbell",1994,"Total","30355","37","350","93","30835"
"Johnson",2010,"0","97","0","8","2","107"
"Johnson",2010,"1","107","1","4","1","113"
"Johnson",2010,"2","107","1","4","0","112"
"Johnson",2010,"3","116","0","4","0","120"
"Johnson",2010,"4","112","2","3","0","117"
"Johnson",2010,"5","123","2","4","2","131"
"Johnson",2010,"6","106","1","2","0","109"
"Johnson",2010,"7","86","0","3","0","89"
"Johnson",2010,"8","89","2","1","0","92"
"Johnson",2010,"9","89","0","0","0","89"
"Johnson",2010,"10","98","0","1","0","99"
"Johnson",2010,"11","96","0","1","0","97"
"Johnson",2010,"12","95","0","1","0","96"
"Johnson",2010,"13","102","0","0","1","103"
"Johnson",2010,"14","92","0","0","0","92"
"Johnson",2010,"15","118","1","1","0","120"
"Johnson",2010,"16","103","3","3","2","111"
"Johnson",2010,"17","109","2","1","0","112"
"Johnson",2010,"18 to 20","219","1","4","2","226"
"Johnson",2010,"21 to 24","256","3","7","3","269"
"Johnson",2010,"25 & over","6082","15","50","30","6177"
"Johnson",2010,"Total","8402","34","102","43","8581"
"Hot Springs",1999,"0","48","0","0","0","48"
"Hot Springs",1999,"1","51","0","0","0","51"
"Hot Springs",1999,"2","39","0","4","0","43"
"Hot Springs",1999,"3","40","0","0","0","40"
"Hot Springs",1999,"4","49","0","0","0","49"
"Hot Springs",1999,"5","35","0","0","0","35"
"Hot Springs",1999,"6","47","0","2","0","49"
"Hot Springs",1999,"7","60","0","1","0","61"
"Hot Springs",1999,"8","52","0","2","0","54"
"Hot Springs",1999,"9","73","0","1","0","74"
"Hot Springs",1999,"10","63","0","1","0","64"
"Hot Springs",1999,"11","62","0","3","0","65"
"Hot Springs",1999,"12","73","0","2","0","75"
"Hot Springs",1999,"13","71","0","1","0","72"
"Hot Springs",1999,"14","88","0","2","0","90"
"Hot Springs",1999,"15","69","0","6","0","75"
"Hot Springs",1999,"16","85","0","7","0","92"
"Hot Springs",1999,"17","76","0","1","0","77"
"Hot Springs",1999,"18 to 20","156","1","3","0","160"
"Hot Springs",1999,"21 to 24","130","0","3","0","133"
"Hot Springs",1999,"25 & over","3476","0","37","0","3513"
"Hot Springs",1999,"Total","4843","1","76","0","4920"
"Albany",1998,"0","326","4","2","4","336"
"Albany",1998,"1","317","8","3","13","341"
"Albany",1998,"2","322","3","2","10","337"
"Albany",1998,"3","305","0","2","4","311"
"Albany",1998,"4","302","10","4","10","326"
"Albany",1998,"5","317","7","4","5","333"
"Albany",1998,"6","278","9","9","3","299"
"Albany",1998,"7","321","5","4","5","335"
"Albany",1998,"8","311","10","2","1","324"
"Albany",1998,"9","318","8","6","12","344"
"Albany",1998,"10","312","9","6","5","332"
"Albany",1998,"11","297","10","5","6","318"
"Albany",1998,"12","321","9","4","8","342"
"Albany",1998,"13","343","7","9","8","367"
"Albany",1998,"14","332","0","5","2","339"
"Albany",1998,"15","357","4","5","5","371"
"Albany",1998,"16","361","1","8","2","372"
"Albany",1998,"17","376","5","1","5","387"
"Albany",1998,"18 to 20","4070","73","42","36","4221"
"Albany",1998,"21 to 24","4708","86","35","89","4918"
"Albany",1998,"25 & over","16282","136","135","374","16927"
"Albany",1998,"Total","30876","404","293","607","32180"
"Hot Springs",1995,"0","46","0","0","0","46"
"Hot Springs",1995,"1","41","0","1","0","42"
"Hot Springs",1995,"2","40","0","5","0","45"
"Hot Springs",1995,"3","43","0","0","0","43"
"Hot Springs",1995,"4","47","0","1","0","48"
"Hot Springs",1995,"5","49","0","1","0","50"
"Hot Springs",1995,"6","50","0","2","0","52"
"Hot Springs",1995,"7","55","0","1","0","56"
"Hot Springs",1995,"8","55","0","3","0","58"
"Hot Springs",1995,"9","70","0","1","0","71"
"Hot Springs",1995,"10","70","0","2","0","72"
"Hot Springs",1995,"11","71","0","4","0","75"
"Hot Springs",1995,"12","81","0","3","0","84"
"Hot Springs",1995,"13","82","0","1","0","83"
"Hot Springs",1995,"14","92","0","2","0","94"
"Hot Springs",1995,"15","78","0","5","0","83"
"Hot Springs",1995,"16","81","0","3","0","84"
"Hot Springs",1995,"17","79","0","1","0","80"
"Hot Springs",1995,"18 to 20","136","1","3","0","140"
"Hot Springs",1995,"21 to 24","122","0","2","0","124"
"Hot Springs",1995,"25 & over","3361","0","37","0","3398"
"Hot Springs",1995,"Total","4749","1","78","0","4828"
"Big Horn",1996,"0","155","0","0","0","155"
"Big Horn",1996,"1","147","0","2","0","149"
"Big Horn",1996,"2","165","0","0","0","165"
"Big Horn",1996,"3","149","0","0","0","149"
"Big Horn",1996,"4","155","0","3","0","158"
"Big Horn",1996,"5","162","0","5","2","169"
"Big Horn",1996,"6","174","0","0","0","174"
"Big Horn",1996,"7","164","0","0","0","164"
"Big Horn",1996,"8","174","0","0","0","174"
"Big Horn",1996,"9","204","0","0","0","204"
"Big Horn",1996,"10","190","0","5","1","196"
"Big Horn",1996,"11","191","0","1","0","192"
"Big Horn",1996,"12","225","0","3","0","228"
"Big Horn",1996,"13","215","0","0","0","215"
"Big Horn",1996,"14","221","0","0","1","222"
"Big Horn",1996,"15","201","0","3","0","204"
"Big Horn",1996,"16","234","0","0","0","234"
"Big Horn",1996,"17","220","0","2","2","224"
"Big Horn",1996,"18 to 20","396","0","6","0","402"
"Big Horn",1996,"21 to 24","402","0","0","0","402"
"Big Horn",1996,"25 & over","7105","0","37","12","7154"
"Big Horn",1996,"Total","11249","0","67","18","11334"
"Converse",1992,"0","162","0","0","0","162"
"Converse",1992,"1","151","1","4","0","156"
"Converse",1992,"2","165","1","0","0","166"
"Converse",1992,"3","168","0","0","0","168"
"Converse",1992,"4","180","0","3","0","183"
"Converse",1992,"5","198","2","3","2","205"
"Converse",1992,"6","179","0","0","0","179"
"Converse",1992,"7","202","1","4","0","207"
"Converse",1992,"8","198","0","0","0","198"
"Converse",1992,"9","239","0","5","1","245"
"Converse",1992,"10","222","0","0","2","224"
"Converse",1992,"11","223","0","2","0","225"
"Converse",1992,"12","230","0","7","0","237"
"Converse",1992,"13","215","0","0","0","215"
"Converse",1992,"14","238","2","3","2","245"
"Converse",1992,"15","206","1","0","1","208"
"Converse",1992,"16","188","0","5","0","193"
"Converse",1992,"17","230","0","3","0","233"
"Converse",1992,"18 to 20","362","0","6","0","368"
"Converse",1992,"21 to 24","389","0","4","0","393"
"Converse",1992,"25 & over","6800","4","50","13","6867"
"Converse",1992,"Total","11145","12","99","21","11277"
"Teton",2007,"0","281","2","3","2","288"
"Teton",2007,"1","307","5","3","1","316"
"Teton",2007,"2","249","3","3","3","258"
"Teton",2007,"3","191","1","2","3","197"
"Teton",2007,"4","175","3","3","3","184"
"Teton",2007,"5","186","1","3","4","194"
"Teton",2007,"6","178","3","2","5","188"
"Teton",2007,"7","177","2","2","5","186"
"Teton",2007,"8","167","2","3","3","175"
"Teton",2007,"9","168","0","1","2","171"
"Teton",2007,"10","222","1","3","5","231"
"Teton",2007,"11","170","2","2","1","175"
"Teton",2007,"12","221","3","1","4","229"
"Teton",2007,"13","208","1","1","2","212"
"Teton",2007,"14","191","1","1","8","201"
"Teton",2007,"15","242","1","1","4","248"
"Teton",2007,"16","234","0","3","2","239"
"Teton",2007,"17","240","1","5","3","249"
"Teton",2007,"18 to 20","473","5","6","8","492"
"Teton",2007,"21 to 24","1234","5","14","17","1270"
"Teton",2007,"25 & over","14448","51","111","159","14769"
"Teton",2007,"Total","19962","93","173","244","20472"
"Laramie",1997,"0","1055","31","10","12","1108"
"Laramie",1997,"1","1036","41","6","28","1111"
"Laramie",1997,"2","1006","44","10","24","1084"
"Laramie",1997,"3","1013","44","5","14","1076"
"Laramie",1997,"4","974","47","26","19","1066"
"Laramie",1997,"5","1051","49","16","21","1137"
"Laramie",1997,"6","1056","22","25","10","1113"
"Laramie",1997,"7","1161","50","8","19","1238"
"Laramie",1997,"8","1070","50","9","18","1147"
"Laramie",1997,"9","1076","59","9","16","1160"
"Laramie",1997,"10","1118","50","13","14","1195"
"Laramie",1997,"11","1147","49","10","16","1222"
"Laramie",1997,"12","1182","28","21","18","1249"
"Laramie",1997,"13","1195","36","11","19","1261"
"Laramie",1997,"14","1220","41","35","14","1310"
"Laramie",1997,"15","1246","44","7","15","1312"
"Laramie",1997,"16","1211","29","12","13","1265"
"Laramie",1997,"17","1173","47","12","20","1252"
"Laramie",1997,"18 to 20","3134","156","45","48","3383"
"Laramie",1997,"21 to 24","4188","257","55","103","4603"
"Laramie",1997,"25 & over","48859","1205","411","561","51036"
"Laramie",1997,"Total","76171","2379","756","1022","80328"
"Carbon",2007,"0","208","4","6","7","225"
"Carbon",2007,"1","201","4","2","0","207"
"Carbon",2007,"2","200","1","1","1","203"
"Carbon",2007,"3","191","3","3","2","199"
"Carbon",2007,"4","186","4","2","3","195"
"Carbon",2007,"5","180","6","7","3","196"
"Carbon",2007,"6","191","4","3","1","199"
"Carbon",2007,"7","156","3","3","0","162"
"Carbon",2007,"8","194","1","4","3","202"
"Carbon",2007,"9","194","4","5","2","205"
"Carbon",2007,"10","200","2","3","2","207"
"Carbon",2007,"11","156","2","5","1","164"
"Carbon",2007,"12","165","1","1","1","168"
"Carbon",2007,"13","180","2","4","2","188"
"Carbon",2007,"14","190","1","4","3","198"
"Carbon",2007,"15","182","0","6","1","189"
"Carbon",2007,"16","213","3","2","3","221"
"Carbon",2007,"17","195","0","5","1","201"
"Carbon",2007,"18 to 20","487","5","6","4","502"
"Carbon",2007,"21 to 24","762","11","15","7","795"
"Carbon",2007,"25 & over","10355","83","140","90","10668"
"Carbon",2007,"Total","14986","144","227","137","15494"
"Washakie",2007,"0","111","2","0","0","113"
"Washakie",2007,"1","108","5","1","2","116"
"Washakie",2007,"2","101","0","1","1","103"
"Washakie",2007,"3","93","0","1","1","95"
"Washakie",2007,"4","108","0","3","0","111"
"Washakie",2007,"5","92","0","1","2","95"
"Washakie",2007,"6","105","0","1","1","107"
"Washakie",2007,"7","97","0","3","1","101"
"Washakie",2007,"8","109","0","1","0","110"
"Washakie",2007,"9","109","2","1","1","113"
"Washakie",2007,"10","114","1","1","1","117"
"Washakie",2007,"11","91","1","3","0","95"
"Washakie",2007,"12","94","0","4","0","98"
"Washakie",2007,"13","102","0","1","2","105"
"Washakie",2007,"14","103","0","4","1","108"
"Washakie",2007,"15","128","2","3","2","135"
"Washakie",2007,"16","132","3","1","1","137"
"Washakie",2007,"17","154","3","4","2","163"
"Washakie",2007,"18 to 20","244","1","5","3","253"
"Washakie",2007,"21 to 24","304","5","1","7","317"
"Washakie",2007,"25 & over","5447","27","68","35","5577"
"Washakie",2007,"Total","7946","52","108","63","8169"
"Albany",1995,"0","347","5","2","10","364"
"Albany",1995,"1","331","9","3","14","357"
"Albany",1995,"2","342","2","5","13","362"
"Albany",1995,"3","336","0","6","5","347"
"Albany",1995,"4","331","8","4","9","352"
"Albany",1995,"5","354","7","3","2","366"
"Albany",1995,"6","315","7","7","4","333"
"Albany",1995,"7","331","8","3","7","349"
"Albany",1995,"8","330","11","3","1","345"
"Albany",1995,"9","358","7","6","9","380"
"Albany",1995,"10","369","6","6","3","384"
"Albany",1995,"11","344","5","5","6","360"
"Albany",1995,"12","365","6","8","12","391"
"Albany",1995,"13","373","5","9","6","393"
"Albany",1995,"14","359","0","7","3","369"
"Albany",1995,"15","373","5","7","5","390"
"Albany",1995,"16","363","1","7","2","373"
"Albany",1995,"17","373","5","1","3","382"
"Albany",1995,"18 to 20","4042","67","28","45","4182"
"Albany",1995,"21 to 24","4674","52","36","123","4885"
"Albany",1995,"25 & over","16496","114","122","346","17078"
"Albany",1995,"Total","31506","330","278","628","32742"
"Lincoln",2001,"0","167","0","4","0","171"
"Lincoln",2001,"1","210","0","1","1","212"
"Lincoln",2001,"2","198","0","4","1","203"
"Lincoln",2001,"3","203","0","1","2","206"
"Lincoln",2001,"4","198","0","2","0","200"
"Lincoln",2001,"5","202","1","2","0","205"
"Lincoln",2001,"6","196","0","2","1","199"
"Lincoln",2001,"7","253","0","1","0","254"
"Lincoln",2001,"8","233","1","2","0","236"
"Lincoln",2001,"9","248","1","0","0","249"
"Lincoln",2001,"10","279","2","3","0","284"
"Lincoln",2001,"11","239","2","6","0","247"
"Lincoln",2001,"12","286","4","1","1","292"
"Lincoln",2001,"13","264","0","2","0","266"
"Lincoln",2001,"14","302","1","1","2","306"
"Lincoln",2001,"15","288","0","1","0","289"
"Lincoln",2001,"16","307","0","1","2","310"
"Lincoln",2001,"17","295","3","2","0","300"
"Lincoln",2001,"18 to 20","588","1","5","3","597"
"Lincoln",2001,"21 to 24","483","1","2","0","486"
"Lincoln",2001,"25 & over","9088","10","55","32","9185"
"Lincoln",2001,"Total","14527","27","98","45","14697"
"Big Horn",1994,"0","147","0","0","0","147"
"Big Horn",1994,"1","141","0","2","0","143"
"Big Horn",1994,"2","162","0","0","0","162"
"Big Horn",1994,"3","152","0","0","0","152"
"Big Horn",1994,"4","157","0","3","0","160"
"Big Horn",1994,"5","153","0","5","2","160"
"Big Horn",1994,"6","160","0","0","0","160"
"Big Horn",1994,"7","170","0","0","0","170"
"Big Horn",1994,"8","176","0","0","0","176"
"Big Horn",1994,"9","210","0","0","0","210"
"Big Horn",1994,"10","194","0","3","2","199"
"Big Horn",1994,"11","192","0","1","0","193"
"Big Horn",1994,"12","226","0","2","0","228"
"Big Horn",1994,"13","208","0","0","0","208"
"Big Horn",1994,"14","218","0","0","1","219"
"Big Horn",1994,"15","189","0","3","0","192"
"Big Horn",1994,"16","207","0","0","0","207"
"Big Horn",1994,"17","207","0","3","3","213"
"Big Horn",1994,"18 to 20","358","0","7","0","365"
"Big Horn",1994,"21 to 24","387","0","0","0","387"
"Big Horn",1994,"25 & over","6859","0","30","10","6899"
"Big Horn",1994,"Total","10873","0","59","18","10950"
"Campbell",1993,"0","451","0","7","4","462"
"Campbell",1993,"1","493","3","11","4","511"
"Campbell",1993,"2","516","1","5","0","522"
"Campbell",1993,"3","520","0","9","0","529"
"Campbell",1993,"4","535","1","9","0","545"
"Campbell",1993,"5","548","0","10","0","558"
"Campbell",1993,"6","578","0","4","1","583"
"Campbell",1993,"7","588","0","12","0","600"
"Campbell",1993,"8","601","2","6","1","610"
"Campbell",1993,"9","620","0","11","5","636"
"Campbell",1993,"10","655","4","10","7","676"
"Campbell",1993,"11","632","0","9","0","641"
"Campbell",1993,"12","666","0","16","4","686"
"Campbell",1993,"13","661","0","14","2","677"
"Campbell",1993,"14","628","0","7","0","635"
"Campbell",1993,"15","611","1","6","5","623"
"Campbell",1993,"16","583","3","6","1","593"
"Campbell",1993,"17","542","2","10","1","555"
"Campbell",1993,"18 to 20","1105","1","12","0","1118"
"Campbell",1993,"21 to 24","1308","4","29","9","1350"
"Campbell",1993,"25 & over","17207","18","161","48","17434"
"Campbell",1993,"Total","30048","40","364","92","30544"
"Goshen",1991,"0","162","0","1","0","163"
"Goshen",1991,"1","155","1","7","0","163"
"Goshen",1991,"2","156","0","0","0","156"
"Goshen",1991,"3","165","0","0","0","165"
"Goshen",1991,"4","170","0","0","0","170"
"Goshen",1991,"5","179","2","2","0","183"
"Goshen",1991,"6","202","0","11","0","213"
"Goshen",1991,"7","171","0","3","0","174"
"Goshen",1991,"8","193","0","3","0","196"
"Goshen",1991,"9","234","0","2","0","236"
"Goshen",1991,"10","209","6","1","2","218"
"Goshen",1991,"11","196","0","6","0","202"
"Goshen",1991,"12","204","0","1","0","205"
"Goshen",1991,"13","203","0","0","0","203"
"Goshen",1991,"14","209","0","0","0","209"
"Goshen",1991,"15","203","0","5","0","208"
"Goshen",1991,"16","205","0","0","0","205"
"Goshen",1991,"17","185","0","1","0","186"
"Goshen",1991,"18 to 20","524","6","2","4","536"
"Goshen",1991,"21 to 24","480","0","0","1","481"
"Goshen",1991,"25 & over","7843","4","37","5","7889"
"Goshen",1991,"Total","12248","19","82","12","12361"
"Park",2014,"0","306","8","5","2","321"
"Park",2014,"1","304","4","3","5","316"
"Park",2014,"2","345","4","5","3","357"
"Park",2014,"3","285","8","2","5","300"
"Park",2014,"4","312","3","4","6","325"
"Park",2014,"5","334","5","3","3","345"
"Park",2014,"6","322","3","2","6","333"
"Park",2014,"7","335","4","3","3","345"
"Park",2014,"8","327","3","7","2","339"
"Park",2014,"9","337","6","2","3","348"
"Park",2014,"10","313","5","3","1","322"
"Park",2014,"11","330","1","5","5","341"
"Park",2014,"12","313","2","6","0","321"
"Park",2014,"13","316","1","3","1","321"
"Park",2014,"14","310","3","6","5","324"
"Park",2014,"15","319","4","3","2","328"
"Park",2014,"16","333","5","7","2","347"
"Park",2014,"17","327","10","6","11","354"
"Park",2014,"18 to 20","1146","45","31","28","1250"
"Park",2014,"21 to 24","1215","79","16","23","1333"
"Park",2014,"25 & over","20014","173","152","160","20499"
"Park",2014,"Total","28143","376","274","276","29069"
"Sheridan",1998,"0","280","0","5","0","285"
"Sheridan",1998,"1","253","1","7","4","265"
"Sheridan",1998,"2","286","0","2","0","288"
"Sheridan",1998,"3","289","0","2","0","291"
"Sheridan",1998,"4","262","0","7","2","271"
"Sheridan",1998,"5","287","2","9","3","301"
"Sheridan",1998,"6","321","0","7","4","332"
"Sheridan",1998,"7","361","0","2","0","363"
"Sheridan",1998,"8","324","0","10","0","334"
"Sheridan",1998,"9","330","0","4","0","334"
"Sheridan",1998,"10","355","0","5","1","361"
"Sheridan",1998,"11","363","0","2","1","366"
"Sheridan",1998,"12","397","5","7","0","409"
"Sheridan",1998,"13","400","2","4","0","406"
"Sheridan",1998,"14","423","0","14","9","446"
"Sheridan",1998,"15","491","1","17","1","510"
"Sheridan",1998,"16","470","0","9","5","484"
"Sheridan",1998,"17","470","0","3","7","480"
"Sheridan",1998,"18 to 20","1052","17","16","0","1085"
"Sheridan",1998,"21 to 24","981","0","19","9","1009"
"Sheridan",1998,"25 & over","17364","12","175","69","17620"
"Sheridan",1998,"Total","25759","40","326","115","26240"
"Lincoln",2005,"0","239","0","1","0","240"
"Lincoln",2005,"1","214","2","2","0","218"
"Lincoln",2005,"2","226","1","4","0","231"
"Lincoln",2005,"3","232","0","1","2","235"
"Lincoln",2005,"4","208","1","2","0","211"
"Lincoln",2005,"5","240","1","3","1","245"
"Lincoln",2005,"6","238","1","2","0","241"
"Lincoln",2005,"7","232","0","5","0","237"
"Lincoln",2005,"8","243","3","2","0","248"
"Lincoln",2005,"9","229","1","1","0","231"
"Lincoln",2005,"10","229","1","5","0","235"
"Lincoln",2005,"11","263","3","5","0","271"
"Lincoln",2005,"12","272","2","1","1","276"
"Lincoln",2005,"13","244","2","3","0","249"
"Lincoln",2005,"14","289","2","2","0","293"
"Lincoln",2005,"15","238","2","3","1","244"
"Lincoln",2005,"16","298","1","2","1","302"
"Lincoln",2005,"17","289","0","2","0","291"
"Lincoln",2005,"18 to 20","555","1","5","2","563"
"Lincoln",2005,"21 to 24","625","3","8","0","636"
"Lincoln",2005,"25 & over","10099","15","70","36","10220"
"Lincoln",2005,"Total","15702","42","129","44","15917"
"Sublette",1994,"0","64","0","0","0","64"
"Sublette",1994,"1","72","0","3","2","77"
"Sublette",1994,"2","69","0","0","0","69"
"Sublette",1994,"3","74","0","0","0","74"
"Sublette",1994,"4","77","0","0","0","77"
"Sublette",1994,"5","68","0","3","0","71"
"Sublette",1994,"6","72","0","0","0","72"
"Sublette",1994,"7","82","0","0","0","82"
"Sublette",1994,"8","77","0","3","0","80"
"Sublette",1994,"9","82","0","0","0","82"
"Sublette",1994,"10","80","0","6","0","86"
"Sublette",1994,"11","108","0","0","0","108"
"Sublette",1994,"12","93","0","0","0","93"
"Sublette",1994,"13","106","0","0","0","106"
"Sublette",1994,"14","93","0","0","0","93"
"Sublette",1994,"15","91","0","0","0","91"
"Sublette",1994,"16","88","0","0","0","88"
"Sublette",1994,"17","84","0","0","0","84"
"Sublette",1994,"18 to 20","153","0","0","0","153"
"Sublette",1994,"21 to 24","187","0","3","0","190"
"Sublette",1994,"25 & over","3545","2","19","3","3569"
"Sublette",1994,"Total","5365","2","37","5","5409"
"Fremont",1993,"0","318","0","176","1","495"
"Fremont",1993,"1","310","5","215","0","530"
"Fremont",1993,"2","341","0","189","3","533"
"Fremont",1993,"3","365","0","189","0","554"
"Fremont",1993,"4","366","0","179","4","549"
"Fremont",1993,"5","370","1","172","2","545"
"Fremont",1993,"6","410","0","166","0","576"
"Fremont",1993,"7","409","0","171","2","582"
"Fremont",1993,"8","429","0","185","2","616"
"Fremont",1993,"9","470","0","178","2","650"
"Fremont",1993,"10","454","4","179","3","640"
"Fremont",1993,"11","471","0","198","2","671"
"Fremont",1993,"12","485","0","167","0","652"
"Fremont",1993,"13","512","4","200","0","716"
"Fremont",1993,"14","486","0","166","0","652"
"Fremont",1993,"15","453","0","136","3","592"
"Fremont",1993,"16","453","3","123","1","580"
"Fremont",1993,"17","427","0","119","0","546"
"Fremont",1993,"18 to 20","935","3","348","2","1288"
"Fremont",1993,"21 to 24","985","4","432","8","1429"
"Fremont",1993,"25 & over","18043","14","3068","47","21172"
"Fremont",1993,"Total","27492","38","6956","82","34568"
"Sublette",2008,"0","152","0","0","0","152"
"Sublette",2008,"1","146","5","2","1","154"
"Sublette",2008,"2","120","0","2","1","123"
"Sublette",2008,"3","101","1","2","0","104"
"Sublette",2008,"4","110","0","2","1","113"
"Sublette",2008,"5","137","0","1","0","138"
"Sublette",2008,"6","113","0","1","2","116"
"Sublette",2008,"7","121","1","1","0","123"
"Sublette",2008,"8","112","0","1","1","114"
"Sublette",2008,"9","141","0","0","1","142"
"Sublette",2008,"10","132","1","1","0","134"
"Sublette",2008,"11","129","0","3","2","134"
"Sublette",2008,"12","104","2","1","1","108"
"Sublette",2008,"13","90","0","3","0","93"
"Sublette",2008,"14","133","0","1","0","134"
"Sublette",2008,"15","108","2","3","2","115"
"Sublette",2008,"16","128","1","4","0","133"
"Sublette",2008,"17","126","1","4","0","131"
"Sublette",2008,"18 to 20","262","3","7","3","275"
"Sublette",2008,"21 to 24","391","3","4","12","410"
"Sublette",2008,"25 & over","6394","40","63","31","6528"
"Sublette",2008,"Total","9250","60","106","58","9474"
"Niobrara",2003,"0","18","0","0","0","18"
"Niobrara",2003,"1","17","1","0","0","18"
"Niobrara",2003,"2","23","1","0","0","24"
"Niobrara",2003,"3","11","0","0","0","11"
"Niobrara",2003,"4","19","0","0","0","19"
"Niobrara",2003,"5","26","0","0","0","26"
"Niobrara",2003,"6","31","0","0","0","31"
"Niobrara",2003,"7","28","0","0","0","28"
"Niobrara",2003,"8","28","0","0","0","28"
"Niobrara",2003,"9","34","1","0","0","35"
"Niobrara",2003,"10","30","0","1","0","31"
"Niobrara",2003,"11","32","0","0","0","32"
"Niobrara",2003,"12","27","1","0","0","28"
"Niobrara",2003,"13","32","0","0","0","32"
"Niobrara",2003,"14","30","0","0","0","30"
"Niobrara",2003,"15","28","0","0","0","28"
"Niobrara",2003,"16","36","0","0","0","36"
"Niobrara",2003,"17","34","0","0","0","34"
"Niobrara",2003,"18 to 20","74","1","0","0","75"
"Niobrara",2003,"21 to 24","70","1","1","0","72"
"Niobrara",2003,"25 & over","1629","1","12","2","1644"
"Niobrara",2003,"Total","2257","7","14","2","2280"
"Hot Springs",1998,"0","48","0","0","0","48"
"Hot Springs",1998,"1","51","0","1","0","52"
"Hot Springs",1998,"2","41","0","4","0","45"
"Hot Springs",1998,"3","43","0","0","0","43"
"Hot Springs",1998,"4","48","0","1","0","49"
"Hot Springs",1998,"5","39","0","1","0","40"
"Hot Springs",1998,"6","49","0","3","0","52"
"Hot Springs",1998,"7","61","0","1","0","62"
"Hot Springs",1998,"8","56","0","2","0","58"
"Hot Springs",1998,"9","70","0","1","0","71"
"Hot Springs",1998,"10","64","0","1","0","65"
"Hot Springs",1998,"11","67","0","2","0","69"
"Hot Springs",1998,"12","77","0","3","0","80"
"Hot Springs",1998,"13","80","0","1","0","81"
"Hot Springs",1998,"14","89","0","2","0","91"
"Hot Springs",1998,"15","78","0","5","0","83"
"Hot Springs",1998,"16","90","0","3","0","93"
"Hot Springs",1998,"17","78","0","2","0","80"
"Hot Springs",1998,"18 to 20","158","1","4","0","163"
"Hot Springs",1998,"21 to 24","132","0","2","0","134"
"Hot Springs",1998,"25 & over","3523","0","35","0","3558"
"Hot Springs",1998,"Total","4942","1","74","0","5017"
"Hot Springs",2003,"0","35","0","1","0","36"
"Hot Springs",2003,"1","47","1","3","0","51"
"Hot Springs",2003,"2","35","2","4","1","42"
"Hot Springs",2003,"3","38","0","0","0","38"
"Hot Springs",2003,"4","45","1","0","0","46"
"Hot Springs",2003,"5","44","0","1","0","45"
"Hot Springs",2003,"6","30","0","0","0","30"
"Hot Springs",2003,"7","67","1","1","0","69"
"Hot Springs",2003,"8","35","0","0","0","35"
"Hot Springs",2003,"9","44","0","2","0","46"
"Hot Springs",2003,"10","46","0","0","0","46"
"Hot Springs",2003,"11","45","0","3","0","48"
"Hot Springs",2003,"12","69","0","2","1","72"
"Hot Springs",2003,"13","60","0","2","0","62"
"Hot Springs",2003,"14","59","1","2","0","62"
"Hot Springs",2003,"15","70","0","4","0","74"
"Hot Springs",2003,"16","56","0","3","0","59"
"Hot Springs",2003,"17","82","0","1","0","83"
"Hot Springs",2003,"18 to 20","163","0","5","1","169"
"Hot Springs",2003,"21 to 24","147","1","4","1","153"
"Hot Springs",2003,"25 & over","3306","7","45","8","3366"
"Hot Springs",2003,"Total","4523","14","83","12","4632"
"Johnson",1997,"0","64","0","0","0","64"
"Johnson",1997,"1","75","0","0","0","75"
"Johnson",1997,"2","69","0","0","0","69"
"Johnson",1997,"3","76","0","0","0","76"
"Johnson",1997,"4","74","0","0","0","74"
"Johnson",1997,"5","80","0","1","0","81"
"Johnson",1997,"6","81","0","4","0","85"
"Johnson",1997,"7","100","0","0","0","100"
"Johnson",1997,"8","90","0","3","0","93"
"Johnson",1997,"9","96","0","2","0","98"
"Johnson",1997,"10","107","0","2","0","109"
"Johnson",1997,"11","108","0","0","0","108"
"Johnson",1997,"12","102","0","0","0","102"
"Johnson",1997,"13","95","0","2","0","97"
"Johnson",1997,"14","121","0","2","0","123"
"Johnson",1997,"15","111","0","1","1","113"
"Johnson",1997,"16","121","0","0","0","121"
"Johnson",1997,"17","133","0","0","0","133"
"Johnson",1997,"18 to 20","206","0","0","0","206"
"Johnson",1997,"21 to 24","191","0","0","0","191"
"Johnson",1997,"25 & over","4694","0","19","0","4713"
"Johnson",1997,"Total","6794","0","36","1","6831"
"Big Horn",2003,"0","140","0","2","0","142"
"Big Horn",2003,"1","136","0","2","1","139"
"Big Horn",2003,"2","136","0","1","0","137"
"Big Horn",2003,"3","163","0","2","0","165"
"Big Horn",2003,"4","145","1","1","0","147"
"Big Horn",2003,"5","157","2","1","0","160"
"Big Horn",2003,"6","138","0","2","2","142"
"Big Horn",2003,"7","153","0","0","1","154"
"Big Horn",2003,"8","170","0","1","0","171"
"Big Horn",2003,"9","148","0","2","0","150"
"Big Horn",2003,"10","165","0","4","0","169"
"Big Horn",2003,"11","179","2","2","0","183"
"Big Horn",2003,"12","205","0","3","1","209"
"Big Horn",2003,"13","183","0","3","2","188"
"Big Horn",2003,"14","174","1","4","1","180"
"Big Horn",2003,"15","212","1","1","2","216"
"Big Horn",2003,"16","193","2","1","1","197"
"Big Horn",2003,"17","181","1","2","2","186"
"Big Horn",2003,"18 to 20","393","2","6","1","402"
"Big Horn",2003,"21 to 24","402","3","4","0","409"
"Big Horn",2003,"25 & over","7140","7","60","20","7227"
"Big Horn",2003,"Total","10913","22","104","34","11073"
"Johnson",2003,"0","57","1","4","0","62"
"Johnson",2003,"1","69","0","2","1","72"
"Johnson",2003,"2","80","0","1","0","81"
"Johnson",2003,"3","70","0","0","0","70"
"Johnson",2003,"4","83","1","1","1","86"
"Johnson",2003,"5","80","0","2","0","82"
"Johnson",2003,"6","108","2","2","0","112"
"Johnson",2003,"7","84","0","3","0","87"
"Johnson",2003,"8","100","2","2","1","105"
"Johnson",2003,"9","91","0","1","0","92"
"Johnson",2003,"10","96","0","2","0","98"
"Johnson",2003,"11","96","0","0","0","96"
"Johnson",2003,"12","105","0","1","0","106"
"Johnson",2003,"13","110","0","1","0","111"
"Johnson",2003,"14","103","0","2","0","105"
"Johnson",2003,"15","103","1","0","1","105"
"Johnson",2003,"16","101","0","1","0","102"
"Johnson",2003,"17","126","0","0","0","126"
"Johnson",2003,"18 to 20","244","0","3","3","250"
"Johnson",2003,"21 to 24","232","2","3","1","238"
"Johnson",2003,"25 & over","5267","7","29","7","5310"
"Johnson",2003,"Total","7405","16","60","15","7496"
"Laramie",2003,"0","1092","64","22","17","1195"
"Laramie",2003,"1","1073","77","30","29","1209"
"Laramie",2003,"2","1007","79","27","27","1140"
"Laramie",2003,"3","988","72","9","25","1094"
"Laramie",2003,"4","999","49","20","20","1088"
"Laramie",2003,"5","1003","67","16","23","1109"
"Laramie",2003,"6","1057","44","9","14","1124"
"Laramie",2003,"7","977","37","18","16","1048"
"Laramie",2003,"8","1018","54","10","14","1096"
"Laramie",2003,"9","1120","46","15","10","1191"
"Laramie",2003,"10","1182","46","17","27","1272"
"Laramie",2003,"11","1106","60","23","9","1198"
"Laramie",2003,"12","1153","32","18","13","1216"
"Laramie",2003,"13","1173","32","14","14","1233"
"Laramie",2003,"14","1132","59","19","15","1225"
"Laramie",2003,"15","1083","36","18","22","1159"
"Laramie",2003,"16","1147","26","16","13","1202"
"Laramie",2003,"17","1174","33","18","17","1242"
"Laramie",2003,"18 to 20","3344","256","52","58","3710"
"Laramie",2003,"21 to 24","4483","288","85","94","4950"
"Laramie",2003,"25 & over","51839","1245","600","699","54383"
"Laramie",2003,"Total","79150","2702","1056","1176","84084"
"Campbell",2000,"0","472","2","7","3","484"
"Campbell",2000,"1","500","3","8","4","515"
"Campbell",2000,"2","525","4","4","2","535"
"Campbell",2000,"3","462","4","6","0","472"
"Campbell",2000,"4","491","5","6","0","502"
"Campbell",2000,"5","503","2","6","1","512"
"Campbell",2000,"6","538","5","7","1","551"
"Campbell",2000,"7","517","7","9","2","535"
"Campbell",2000,"8","546","5","6","2","559"
"Campbell",2000,"9","586","5","10","6","607"
"Campbell",2000,"10","563","2","7","3","575"
"Campbell",2000,"11","579","1","7","2","589"
"Campbell",2000,"12","620","1","9","6","636"
"Campbell",2000,"13","635","2","10","2","649"
"Campbell",2000,"14","659","3","10","2","674"
"Campbell",2000,"15","733","0","8","4","745"
"Campbell",2000,"16","695","2","10","3","710"
"Campbell",2000,"17","656","2","11","4","673"
"Campbell",2000,"18 to 20","1466","3","20","2","1491"
"Campbell",2000,"21 to 24","1695","4","25","12","1736"
"Campbell",2000,"25 & over","19917","34","192","86","20229"
"Campbell",2000,"Total","33358","96","378","147","33979"
"Weston",2007,"0","76","0","3","1","80"
"Weston",2007,"1","67","1","0","1","69"
"Weston",2007,"2","70","1","2","1","74"
"Weston",2007,"3","67","2","3","0","72"
"Weston",2007,"4","73","1","1","0","75"
"Weston",2007,"5","75","2","2","0","79"
"Weston",2007,"6","90","0","2","0","92"
"Weston",2007,"7","74","1","2","1","78"
"Weston",2007,"8","80","2","2","1","85"
"Weston",2007,"9","84","0","1","0","85"
"Weston",2007,"10","73","1","0","1","75"
"Weston",2007,"11","72","0","3","0","75"
"Weston",2007,"12","72","0","2","0","74"
"Weston",2007,"13","92","1","2","0","95"
"Weston",2007,"14","73","0","1","0","74"
"Weston",2007,"15","94","0","3","0","97"
"Weston",2007,"16","102","0","2","0","104"
"Weston",2007,"17","94","1","0","0","95"
"Weston",2007,"18 to 20","241","1","8","1","251"
"Weston",2007,"21 to 24","351","4","3","1","359"
"Weston",2007,"25 & over","4843","17","69","16","4945"
"Weston",2007,"Total","6863","35","111","24","7033"
"Big Horn",2007,"0","146","1","6","0","153"
"Big Horn",2007,"1","167","1","3","0","171"
"Big Horn",2007,"2","141","3","0","0","144"
"Big Horn",2007,"3","122","0","2","0","124"
"Big Horn",2007,"4","156","0","0","1","157"
"Big Horn",2007,"5","166","0","0","0","166"
"Big Horn",2007,"6","153","0","0","1","154"
"Big Horn",2007,"7","158","1","0","2","161"
"Big Horn",2007,"8","153","2","1","0","156"
"Big Horn",2007,"9","138","1","2","1","142"
"Big Horn",2007,"10","163","1","4","2","170"
"Big Horn",2007,"11","163","3","1","0","167"
"Big Horn",2007,"12","168","1","1","1","171"
"Big Horn",2007,"13","159","0","0","1","160"
"Big Horn",2007,"14","168","3","4","0","175"
"Big Horn",2007,"15","197","3","2","0","202"
"Big Horn",2007,"16","186","1","1","0","188"
"Big Horn",2007,"17","191","1","3","0","195"
"Big Horn",2007,"18 to 20","341","8","5","1","355"
"Big Horn",2007,"21 to 24","444","4","8","0","456"
"Big Horn",2007,"25 & over","7449","24","90","20","7583"
"Big Horn",2007,"Total","11129","58","133","30","11350"
"Sweetwater",1997,"0","529","6","5","1","541"
"Sweetwater",1997,"1","555","4","5","3","567"
"Sweetwater",1997,"2","516","9","15","1","541"
"Sweetwater",1997,"3","522","14","7","1","544"
"Sweetwater",1997,"4","516","4","5","1","526"
"Sweetwater",1997,"5","520","6","6","3","535"
"Sweetwater",1997,"6","595","1","15","2","613"
"Sweetwater",1997,"7","616","7","15","2","640"
"Sweetwater",1997,"8","627","3","6","3","639"
"Sweetwater",1997,"9","642","3","8","4","657"
"Sweetwater",1997,"10","626","4","10","1","641"
"Sweetwater",1997,"11","675","5","9","4","693"
"Sweetwater",1997,"12","733","7","6","3","749"
"Sweetwater",1997,"13","779","6","9","2","796"
"Sweetwater",1997,"14","761","9","8","2","780"
"Sweetwater",1997,"15","755","6","8","2","771"
"Sweetwater",1997,"16","789","8","8","6","811"
"Sweetwater",1997,"17","824","4","10","5","843"
"Sweetwater",1997,"18 to 20","1884","15","16","24","1939"
"Sweetwater",1997,"21 to 24","1763","21","19","22","1825"
"Sweetwater",1997,"25 & over","22554","159","187","177","23077"
"Sweetwater",1997,"Total","37781","301","377","269","38728"
"Sheridan",2016,"0","289","6","7","7","309"
"Sheridan",2016,"1","309","3","7","6","325"
"Sheridan",2016,"2","340","5","17","11","373"
"Sheridan",2016,"3","299","2","8","7","316"
"Sheridan",2016,"4","315","3","7","3","328"
"Sheridan",2016,"5","332","4","7","11","354"
"Sheridan",2016,"6","357","6","8","3","374"
"Sheridan",2016,"7","336","3","8","0","347"
"Sheridan",2016,"8","382","5","10","7","404"
"Sheridan",2016,"9","381","5","6","3","395"
"Sheridan",2016,"10","363","8","6","0","377"
"Sheridan",2016,"11","328","15","6","3","352"
"Sheridan",2016,"12","345","7","5","1","358"
"Sheridan",2016,"13","340","13","7","2","362"
"Sheridan",2016,"14","325","5","4","1","335"
"Sheridan",2016,"15","325","7","12","2","346"
"Sheridan",2016,"16","388","5","13","3","409"
"Sheridan",2016,"17","343","5","7","2","357"
"Sheridan",2016,"18 to 20","1031","22","37","14","1104"
"Sheridan",2016,"21 to 24","1335","24","31","13","1403"
"Sheridan",2016,"25 & over","20611","203","270","188","21272"
"Sheridan",2016,"Total","29074","356","483","287","30200"
"Fremont",2007,"0","309","4","298","2","613"
"Fremont",2007,"1","309","1","259","0","569"
"Fremont",2007,"2","291","6","241","3","541"
"Fremont",2007,"3","338","7","205","1","551"
"Fremont",2007,"4","321","4","241","5","571"
"Fremont",2007,"5","353","3","108","2","466"
"Fremont",2007,"6","337","2","204","4","547"
"Fremont",2007,"7","371","7","130","2","510"
"Fremont",2007,"8","353","3","205","2","563"
"Fremont",2007,"9","321","4","183","2","510"
"Fremont",2007,"10","290","3","135","0","428"
"Fremont",2007,"11","328","3","152","2","485"
"Fremont",2007,"12","324","3","149","2","478"
"Fremont",2007,"13","400","2","216","2","620"
"Fremont",2007,"14","323","5","180","5","513"
"Fremont",2007,"15","381","0","198","2","581"
"Fremont",2007,"16","390","4","167","4","565"
"Fremont",2007,"17","400","1","145","0","546"
"Fremont",2007,"18 to 20","1059","4","475","7","1545"
"Fremont",2007,"21 to 24","1292","9","522","5","1828"
"Fremont",2007,"25 & over","20853","64","4092","93","25102"
"Fremont",2007,"Total","29343","139","8505","145","38132"
"Big Horn",2008,"0","150","2","8","0","160"
"Big Horn",2008,"1","152","0","4","0","156"
"Big Horn",2008,"2","145","3","0","0","148"
"Big Horn",2008,"3","158","0","3","0","161"
"Big Horn",2008,"4","124","0","1","1","126"
"Big Horn",2008,"5","186","0","0","0","186"
"Big Horn",2008,"6","149","0","0","2","151"
"Big Horn",2008,"7","163","1","0","2","166"
"Big Horn",2008,"8","165","2","0","0","167"
"Big Horn",2008,"9","134","1","2","1","138"
"Big Horn",2008,"10","168","1","4","2","175"
"Big Horn",2008,"11","164","3","1","0","168"
"Big Horn",2008,"12","171","1","0","2","174"
"Big Horn",2008,"13","153","0","0","1","154"
"Big Horn",2008,"14","170","3","4","0","177"
"Big Horn",2008,"15","176","3","1","1","181"
"Big Horn",2008,"16","184","0","0","0","184"
"Big Horn",2008,"17","199","1","3","0","203"
"Big Horn",2008,"18 to 20","356","5","6","1","368"
"Big Horn",2008,"21 to 24","417","7","9","0","433"
"Big Horn",2008,"25 & over","7503","25","89","26","7643"
"Big Horn",2008,"Total","11187","58","135","39","11419"
"Washakie",2006,"0","113","2","0","0","115"
"Washakie",2006,"1","92","4","2","1","99"
"Washakie",2006,"2","73","0","0","2","75"
"Washakie",2006,"3","106","0","0","0","106"
"Washakie",2006,"4","87","0","3","0","90"
"Washakie",2006,"5","102","0","0","2","104"
"Washakie",2006,"6","93","1","0","0","94"
"Washakie",2006,"7","95","0","3","1","99"
"Washakie",2006,"8","116","0","1","0","117"
"Washakie",2006,"9","107","1","1","1","110"
"Washakie",2006,"10","92","2","1","1","96"
"Washakie",2006,"11","92","1","3","1","97"
"Washakie",2006,"12","93","0","4","0","97"
"Washakie",2006,"13","107","0","1","3","111"
"Washakie",2006,"14","118","0","4","0","122"
"Washakie",2006,"15","114","2","4","3","123"
"Washakie",2006,"16","164","3","2","0","169"
"Washakie",2006,"17","122","3","3","1","129"
"Washakie",2006,"18 to 20","240","1","5","3","249"
"Washakie",2006,"21 to 24","315","5","1","7","328"
"Washakie",2006,"25 & over","5325","24","67","33","5449"
"Washakie",2006,"Total","7766","49","105","59","7979"
"Platte",2003,"0","95","0","1","0","96"
"Platte",2003,"1","91","0","1","0","92"
"Platte",2003,"2","85","0","0","0","85"
"Platte",2003,"3","98","1","1","1","101"
"Platte",2003,"4","87","1","0","0","88"
"Platte",2003,"5","99","2","0","1","102"
"Platte",2003,"6","99","0","2","0","101"
"Platte",2003,"7","100","1","0","1","102"
"Platte",2003,"8","112","0","0","0","112"
"Platte",2003,"9","104","0","0","1","105"
"Platte",2003,"10","123","0","2","1","126"
"Platte",2003,"11","129","1","1","1","132"
"Platte",2003,"12","124","1","1","0","126"
"Platte",2003,"13","169","0","0","0","169"
"Platte",2003,"14","118","0","1","2","121"
"Platte",2003,"15","144","1","1","0","146"
"Platte",2003,"16","136","1","1","1","139"
"Platte",2003,"17","141","0","3","0","144"
"Platte",2003,"18 to 20","307","2","4","2","315"
"Platte",2003,"21 to 24","271","0","3","1","275"
"Platte",2003,"25 & over","5963","9","30","10","6012"
"Platte",2003,"Total","8595","20","52","22","8689"
"Park",1991,"0","295","0","1","1","297"
"Park",1991,"1","336","0","7","0","343"
"Park",1991,"2","316","0","1","3","320"
"Park",1991,"3","327","0","0","0","327"
"Park",1991,"4","347","0","1","1","349"
"Park",1991,"5","356","1","2","5","364"
"Park",1991,"6","374","0","0","1","375"
"Park",1991,"7","366","0","3","1","370"
"Park",1991,"8","383","0","2","1","386"
"Park",1991,"9","396","0","2","1","399"
"Park",1991,"10","386","0","9","0","395"
"Park",1991,"11","405","0","0","6","411"
"Park",1991,"12","392","0","4","1","397"
"Park",1991,"13","359","1","1","1","362"
"Park",1991,"14","361","1","0","1","363"
"Park",1991,"15","342","1","3","0","346"
"Park",1991,"16","350","0","4","3","357"
"Park",1991,"17","339","0","1","0","340"
"Park",1991,"18 to 20","1181","0","13","11","1205"
"Park",1991,"21 to 24","877","0","2","15","894"
"Park",1991,"25 & over","14589","8","57","49","14703"
"Park",1991,"Total","23077","12","113","101","23303"
"Lincoln",1998,"0","191","0","2","0","193"
"Lincoln",1998,"1","206","0","2","2","210"
"Lincoln",1998,"2","197","0","2","0","199"
"Lincoln",1998,"3","184","0","0","0","184"
"Lincoln",1998,"4","195","0","0","0","195"
"Lincoln",1998,"5","205","2","0","0","207"
"Lincoln",1998,"6","234","0","0","1","235"
"Lincoln",1998,"7","240","0","0","0","240"
"Lincoln",1998,"8","253","0","3","0","256"
"Lincoln",1998,"9","277","0","2","0","279"
"Lincoln",1998,"10","228","1","7","2","238"
"Lincoln",1998,"11","289","0","0","0","289"
"Lincoln",1998,"12","285","0","1","0","286"
"Lincoln",1998,"13","314","0","3","0","317"
"Lincoln",1998,"14","288","0","0","0","288"
"Lincoln",1998,"15","321","3","1","0","325"
"Lincoln",1998,"16","310","0","1","0","311"
"Lincoln",1998,"17","323","0","0","0","323"
"Lincoln",1998,"18 to 20","541","4","6","0","551"
"Lincoln",1998,"21 to 24","459","0","0","0","459"
"Lincoln",1998,"25 & over","8473","1","30","25","8529"
"Lincoln",1998,"Total","14013","11","60","30","14114"
"Sweetwater",2013,"0","619","12","17","11","659"
"Sweetwater",2013,"1","538","20","16","7","581"
"Sweetwater",2013,"2","631","7","9","10","657"
"Sweetwater",2013,"3","632","12","16","5","665"
"Sweetwater",2013,"4","713","15","8","10","746"
"Sweetwater",2013,"5","748","16","15","6","785"
"Sweetwater",2013,"6","718","13","15","6","752"
"Sweetwater",2013,"7","712","17","13","7","749"
"Sweetwater",2013,"8","682","16","13","8","719"
"Sweetwater",2013,"9","647","10","10","10","677"
"Sweetwater",2013,"10","658","13","18","8","697"
"Sweetwater",2013,"11","642","14","8","6","670"
"Sweetwater",2013,"12","618","15","11","8","652"
"Sweetwater",2013,"13","621","11","11","6","649"
"Sweetwater",2013,"14","624","10","8","3","645"
"Sweetwater",2013,"15","596","16","10","4","626"
"Sweetwater",2013,"16","595","12","11","4","622"
"Sweetwater",2013,"17","588","21","11","8","628"
"Sweetwater",2013,"18 to 20","1640","61","40","28","1769"
"Sweetwater",2013,"21 to 24","2283","60","47","33","2423"
"Sweetwater",2013,"25 & over","27593","517","368","295","28773"
"Sweetwater",2013,"Total","43098","888","675","483","45144"
"Campbell",2016,"0","700","14","20","9","743"
"Campbell",2016,"1","742","9","13","6","770"
"Campbell",2016,"2","746","13","23","6","788"
"Campbell",2016,"3","712","13","25","9","759"
"Campbell",2016,"4","735","18","14","10","777"
"Campbell",2016,"5","683","12","30","7","732"
"Campbell",2016,"6","839","9","17","8","873"
"Campbell",2016,"7","781","8","18","8","815"
"Campbell",2016,"8","839","9","16","2","866"
"Campbell",2016,"9","804","15","17","2","838"
"Campbell",2016,"10","752","6","16","3","777"
"Campbell",2016,"11","716","4","14","6","740"
"Campbell",2016,"12","747","9","12","5","773"
"Campbell",2016,"13","662","11","18","7","698"
"Campbell",2016,"14","652","7","14","3","676"
"Campbell",2016,"15","675","8","14","4","701"
"Campbell",2016,"16","691","8","23","12","734"
"Campbell",2016,"17","655","4","13","5","677"
"Campbell",2016,"18 to 20","1472","35","35","10","1552"
"Campbell",2016,"21 to 24","2404","38","67","27","2536"
"Campbell",2016,"25 & over","30002","238","473","265","30978"
"Campbell",2016,"Total","47009","488","892","414","48803"
"Fremont",2016,"0","381","4","156","4","545"
"Fremont",2016,"1","383","13","171","3","570"
"Fremont",2016,"2","355","8","235","0","598"
"Fremont",2016,"3","334","7","234","2","577"
"Fremont",2016,"4","358","1","246","2","607"
"Fremont",2016,"5","343","11","258","4","616"
"Fremont",2016,"6","376","5","217","3","601"
"Fremont",2016,"7","383","5","207","3","598"
"Fremont",2016,"8","366","4","230","3","603"
"Fremont",2016,"9","397","6","199","4","606"
"Fremont",2016,"10","356","6","239","1","602"
"Fremont",2016,"11","338","4","214","5","561"
"Fremont",2016,"12","337","5","212","6","560"
"Fremont",2016,"13","351","2","189","4","546"
"Fremont",2016,"14","329","5","195","3","532"
"Fremont",2016,"15","345","7","177","2","531"
"Fremont",2016,"16","337","6","160","2","505"
"Fremont",2016,"17","351","5","155","3","514"
"Fremont",2016,"18 to 20","926","13","446","10","1395"
"Fremont",2016,"21 to 24","1214","15","569","8","1806"
"Fremont",2016,"25 & over","21866","172","4569","162","26769"
"Fremont",2016,"Total","30426","304","9278","234","40242"
"Washakie",1997,"0","97","0","0","2","99"
"Washakie",1997,"1","107","0","3","0","110"
"Washakie",1997,"2","103","0","0","2","105"
"Washakie",1997,"3","98","0","0","0","98"
"Washakie",1997,"4","99","0","0","0","99"
"Washakie",1997,"5","106","3","4","3","116"
"Washakie",1997,"6","98","0","0","1","99"
"Washakie",1997,"7","120","0","0","0","120"
"Washakie",1997,"8","134","0","0","0","134"
"Washakie",1997,"9","133","0","0","0","133"
"Washakie",1997,"10","156","0","0","1","157"
"Washakie",1997,"11","147","0","0","0","147"
"Washakie",1997,"12","148","0","2","2","152"
"Washakie",1997,"13","152","0","1","0","153"
"Washakie",1997,"14","169","0","2","0","171"
"Washakie",1997,"15","179","0","5","0","184"
"Washakie",1997,"16","190","0","0","0","190"
"Washakie",1997,"17","156","0","0","1","157"
"Washakie",1997,"18 to 20","275","1","1","0","277"
"Washakie",1997,"21 to 24","273","0","0","0","273"
"Washakie",1997,"25 & over","5515","1","22","19","5557"
"Washakie",1997,"Total","8455","5","40","31","8531"
"Sublette",1996,"0","62","0","0","0","62"
"Sublette",1996,"1","71","0","2","1","74"
"Sublette",1996,"2","66","0","0","0","66"
"Sublette",1996,"3","70","0","0","0","70"
"Sublette",1996,"4","73","0","0","0","73"
"Sublette",1996,"5","67","0","2","0","69"
"Sublette",1996,"6","79","0","0","0","79"
"Sublette",1996,"7","81","0","0","0","81"
"Sublette",1996,"8","77","0","2","0","79"
"Sublette",1996,"9","77","0","0","0","77"
"Sublette",1996,"10","84","0","5","0","89"
"Sublette",1996,"11","108","0","0","0","108"
"Sublette",1996,"12","96","0","0","0","96"
"Sublette",1996,"13","109","0","0","0","109"
"Sublette",1996,"14","95","0","0","0","95"
"Sublette",1996,"15","95","0","0","0","95"
"Sublette",1996,"16","97","0","0","0","97"
"Sublette",1996,"17","86","0","0","0","86"
"Sublette",1996,"18 to 20","158","0","0","0","158"
"Sublette",1996,"21 to 24","191","0","2","0","193"
"Sublette",1996,"25 & over","3723","2","18","2","3745"
"Sublette",1996,"Total","5565","2","31","3","5601"
"Hot Springs",2009,"0","40","0","1","0","41"
"Hot Springs",2009,"1","71","1","3","0","75"
"Hot Springs",2009,"2","47","1","1","0","49"
"Hot Springs",2009,"3","41","1","1","0","43"
"Hot Springs",2009,"4","48","1","0","0","49"
"Hot Springs",2009,"5","46","0","2","0","48"
"Hot Springs",2009,"6","43","1","0","0","44"
"Hot Springs",2009,"7","63","1","0","1","65"
"Hot Springs",2009,"8","52","1","1","0","54"
"Hot Springs",2009,"9","50","1","2","1","54"
"Hot Springs",2009,"10","70","0","1","0","71"
"Hot Springs",2009,"11","50","1","1","0","52"
"Hot Springs",2009,"12","56","0","0","1","57"
"Hot Springs",2009,"13","72","1","2","1","76"
"Hot Springs",2009,"14","47","2","1","1","51"
"Hot Springs",2009,"15","54","0","1","1","56"
"Hot Springs",2009,"16","48","1","2","0","51"
"Hot Springs",2009,"17","50","1","3","0","54"
"Hot Springs",2009,"18 to 20","117","0","5","1","123"
"Hot Springs",2009,"21 to 24","184","4","9","3","200"
"Hot Springs",2009,"25 & over","3450","9","35","12","3506"
"Hot Springs",2009,"Total","4699","27","71","22","4819"
"Albany",2003,"0","369","9","6","12","396"
"Albany",2003,"1","321","14","4","16","355"
"Albany",2003,"2","344","15","3","2","364"
"Albany",2003,"3","273","9","5","8","295"
"Albany",2003,"4","267","10","5","9","291"
"Albany",2003,"5","283","14","6","9","312"
"Albany",2003,"6","264","8","6","11","289"
"Albany",2003,"7","266","9","7","8","290"
"Albany",2003,"8","277","9","3","5","294"
"Albany",2003,"9","250","8","4","4","266"
"Albany",2003,"10","308","8","7","6","329"
"Albany",2003,"11","269","8","3","6","286"
"Albany",2003,"12","274","8","5","7","294"
"Albany",2003,"13","301","6","5","6","318"
"Albany",2003,"14","261","5","4","4","274"
"Albany",2003,"15","292","8","6","4","310"
"Albany",2003,"16","316","3","8","5","332"
"Albany",2003,"17","313","7","5","4","329"
"Albany",2003,"18 to 20","4363","60","41","79","4543"
"Albany",2003,"21 to 24","5959","102","60","171","6292"
"Albany",2003,"25 & over","15898","167","199","375","16639"
"Albany",2003,"Total","31468","487","392","751","33098"
"Crook",1991,"0","88","0","0","0","88"
"Crook",1991,"1","77","0","1","0","78"
"Crook",1991,"2","82","0","0","0","82"
"Crook",1991,"3","75","0","0","0","75"
"Crook",1991,"4","89","0","0","0","89"
"Crook",1991,"5","81","0","1","0","82"
"Crook",1991,"6","102","0","0","0","102"
"Crook",1991,"7","99","0","0","0","99"
"Crook",1991,"8","104","0","0","0","104"
"Crook",1991,"9","108","0","0","0","108"
"Crook",1991,"10","108","0","2","0","110"
"Crook",1991,"11","110","0","0","0","110"
"Crook",1991,"12","109","0","0","0","109"
"Crook",1991,"13","102","0","0","0","102"
"Crook",1991,"14","96","0","0","0","96"
"Crook",1991,"15","89","0","1","0","90"
"Crook",1991,"16","91","0","0","0","91"
"Crook",1991,"17","80","0","0","0","80"
"Crook",1991,"18 to 20","155","0","2","0","157"
"Crook",1991,"21 to 24","161","0","0","0","161"
"Crook",1991,"25 & over","3284","0","18","0","3302"
"Crook",1991,"Total","5290","0","25","0","5315"
"Washakie",2005,"0","97","2","0","0","99"
"Washakie",2005,"1","79","3","1","0","83"
"Washakie",2005,"2","100","0","0","1","101"
"Washakie",2005,"3","85","0","1","1","87"
"Washakie",2005,"4","98","0","3","0","101"
"Washakie",2005,"5","95","1","2","2","100"
"Washakie",2005,"6","101","0","0","0","101"
"Washakie",2005,"7","110","0","1","2","113"
"Washakie",2005,"8","117","0","1","0","118"
"Washakie",2005,"9","82","2","0","1","85"
"Washakie",2005,"10","102","2","0","1","105"
"Washakie",2005,"11","85","1","1","0","87"
"Washakie",2005,"12","92","0","5","0","97"
"Washakie",2005,"13","122","0","1","2","125"
"Washakie",2005,"14","112","0","6","1","119"
"Washakie",2005,"15","147","2","3","1","153"
"Washakie",2005,"16","134","2","3","0","139"
"Washakie",2005,"17","124","3","3","2","132"
"Washakie",2005,"18 to 20","269","1","5","1","276"
"Washakie",2005,"21 to 24","338","4","1","5","348"
"Washakie",2005,"25 & over","5346","19","52","36","5453"
"Washakie",2005,"Total","7835","42","89","56","8022"
"Converse",1991,"0","166","0","0","0","166"
"Converse",1991,"1","160","3","3","0","166"
"Converse",1991,"2","162","1","0","0","163"
"Converse",1991,"3","166","0","0","0","166"
"Converse",1991,"4","188","0","3","0","191"
"Converse",1991,"5","206","2","2","2","212"
"Converse",1991,"6","190","0","0","0","190"
"Converse",1991,"7","200","1","4","0","205"
"Converse",1991,"8","206","0","0","0","206"
"Converse",1991,"9","241","0","6","2","249"
"Converse",1991,"10","222","0","0","1","223"
"Converse",1991,"11","228","0","2","0","230"
"Converse",1991,"12","216","0","7","0","223"
"Converse",1991,"13","204","0","0","0","204"
"Converse",1991,"14","234","1","3","2","240"
"Converse",1991,"15","194","1","0","1","196"
"Converse",1991,"16","186","0","5","0","191"
"Converse",1991,"17","219","0","2","0","221"
"Converse",1991,"18 to 20","350","0","5","0","355"
"Converse",1991,"21 to 24","374","0","4","0","378"
"Converse",1991,"25 & over","6644","4","43","15","6706"
"Converse",1991,"Total","10956","13","89","23","11081"
"Crook",2009,"0","110","1","0","0","111"
"Crook",2009,"1","104","0","0","0","104"
"Crook",2009,"2","96","2","0","1","99"
"Crook",2009,"3","85","1","1","0","87"
"Crook",2009,"4","70","0","1","1","72"
"Crook",2009,"5","92","2","0","0","94"
"Crook",2009,"6","80","1","2","0","83"
"Crook",2009,"7","98","2","0","0","100"
"Crook",2009,"8","79","1","1","1","82"
"Crook",2009,"9","78","1","3","0","82"
"Crook",2009,"10","76","1","0","0","77"
"Crook",2009,"11","73","1","2","0","76"
"Crook",2009,"12","86","0","0","0","86"
"Crook",2009,"13","103","0","1","0","104"
"Crook",2009,"14","75","0","0","0","75"
"Crook",2009,"15","99","0","2","0","101"
"Crook",2009,"16","106","1","1","0","108"
"Crook",2009,"17","98","0","2","0","100"
"Crook",2009,"18 to 20","221","1","1","0","223"
"Crook",2009,"21 to 24","254","0","3","0","257"
"Crook",2009,"25 & over","4796","9","32","7","4844"
"Crook",2009,"Total","6879","24","52","10","6965"
"Converse",1998,"0","150","0","0","0","150"
"Converse",1998,"1","136","1","5","0","142"
"Converse",1998,"2","142","0","0","0","142"
"Converse",1998,"3","163","0","0","0","163"
"Converse",1998,"4","172","0","3","0","175"
"Converse",1998,"5","177","3","2","1","183"
"Converse",1998,"6","152","0","0","0","152"
"Converse",1998,"7","187","0","3","0","190"
"Converse",1998,"8","196","0","0","0","196"
"Converse",1998,"9","202","0","5","1","208"
"Converse",1998,"10","183","0","0","2","185"
"Converse",1998,"11","190","0","2","0","192"
"Converse",1998,"12","212","0","4","0","216"
"Converse",1998,"13","237","0","0","0","237"
"Converse",1998,"14","235","6","6","1","248"
"Converse",1998,"15","236","1","0","3","240"
"Converse",1998,"16","231","0","3","0","234"
"Converse",1998,"17","260","0","4","0","264"
"Converse",1998,"18 to 20","401","0","6","0","407"
"Converse",1998,"21 to 24","437","0","3","0","440"
"Converse",1998,"25 & over","7473","4","60","10","7547"
"Converse",1998,"Total","11772","15","106","18","11911"
"Washakie",2015,"0","99","2","2","0","103"
"Washakie",2015,"1","93","1","3","0","97"
"Washakie",2015,"2","85","2","11","0","98"
"Washakie",2015,"3","87","4","5","1","97"
"Washakie",2015,"4","102","2","1","0","105"
"Washakie",2015,"5","96","1","1","1","99"
"Washakie",2015,"6","91","2","1","1","95"
"Washakie",2015,"7","93","0","1","3","97"
"Washakie",2015,"8","109","0","3","3","115"
"Washakie",2015,"9","124","2","4","0","130"
"Washakie",2015,"10","108","2","2","1","113"
"Washakie",2015,"11","115","0","1","2","118"
"Washakie",2015,"12","109","2","3","2","116"
"Washakie",2015,"13","109","0","4","0","113"
"Washakie",2015,"14","114","1","2","0","117"
"Washakie",2015,"15","125","1","1","2","129"
"Washakie",2015,"16","120","1","3","2","126"
"Washakie",2015,"17","121","1","6","1","129"
"Washakie",2015,"18 to 20","233","6","8","6","253"
"Washakie",2015,"21 to 24","294","7","9","3","313"
"Washakie",2015,"25 & over","5588","54","83","46","5771"
"Washakie",2015,"Total","8015","91","154","74","8334"
"Washakie",2014,"0","85","2","2","0","89"
"Washakie",2014,"1","84","3","9","0","96"
"Washakie",2014,"2","82","3","5","1","91"
"Washakie",2014,"3","105","3","1","0","109"
"Washakie",2014,"4","97","1","1","0","99"
"Washakie",2014,"5","91","3","1","1","96"
"Washakie",2014,"6","95","1","1","3","100"
"Washakie",2014,"7","102","1","2","3","108"
"Washakie",2014,"8","124","2","4","0","130"
"Washakie",2014,"9","111","1","2","1","115"
"Washakie",2014,"10","108","0","1","2","111"
"Washakie",2014,"11","116","1","3","2","122"
"Washakie",2014,"12","108","1","3","0","112"
"Washakie",2014,"13","117","0","4","0","121"
"Washakie",2014,"14","114","1","1","1","117"
"Washakie",2014,"15","118","1","3","1","123"
"Washakie",2014,"16","125","1","7","0","133"
"Washakie",2014,"17","124","2","1","2","129"
"Washakie",2014,"18 to 20","237","7","11","4","259"
"Washakie",2014,"21 to 24","266","9","10","2","287"
"Washakie",2014,"25 & over","5586","45","81","47","5759"
"Washakie",2014,"Total","7995","88","153","70","8306"
"Teton",1991,"0","184","0","2","1","187"
"Teton",1991,"1","195","2","0","1","198"
"Teton",1991,"2","172","0","3","0","175"
"Teton",1991,"3","176","0","0","1","177"
"Teton",1991,"4","176","0","3","0","179"
"Teton",1991,"5","165","0","2","0","167"
"Teton",1991,"6","162","0","0","0","162"
"Teton",1991,"7","161","3","3","0","167"
"Teton",1991,"8","166","0","0","3","169"
"Teton",1991,"9","169","1","0","0","170"
"Teton",1991,"10","165","1","3","0","169"
"Teton",1991,"11","150","0","0","0","150"
"Teton",1991,"12","146","0","0","0","146"
"Teton",1991,"13","160","0","0","0","160"
"Teton",1991,"14","149","0","5","2","156"
"Teton",1991,"15","125","1","2","2","130"
"Teton",1991,"16","131","0","3","0","134"
"Teton",1991,"17","128","0","0","0","128"
"Teton",1991,"18 to 20","326","2","6","0","334"
"Teton",1991,"21 to 24","616","2","4","6","628"
"Teton",1991,"25 & over","8118","9","53","32","8212"
"Teton",1991,"Total","11940","21","89","48","12098"
"Sublette",1998,"0","62","0","0","0","62"
"Sublette",1998,"1","75","0","2","2","79"
"Sublette",1998,"2","65","0","0","0","65"
"Sublette",1998,"3","73","0","0","0","73"
"Sublette",1998,"4","71","0","0","0","71"
"Sublette",1998,"5","66","0","1","0","67"
"Sublette",1998,"6","85","0","0","0","85"
"Sublette",1998,"7","79","0","0","0","79"
"Sublette",1998,"8","83","0","2","0","85"
"Sublette",1998,"9","77","0","0","0","77"
"Sublette",1998,"10","83","0","3","0","86"
"Sublette",1998,"11","102","0","0","0","102"
"Sublette",1998,"12","96","0","0","0","96"
"Sublette",1998,"13","110","0","0","0","110"
"Sublette",1998,"14","92","0","0","0","92"
"Sublette",1998,"15","95","0","0","0","95"
"Sublette",1998,"16","101","0","0","0","101"
"Sublette",1998,"17","88","0","0","0","88"
"Sublette",1998,"18 to 20","169","0","0","0","169"
"Sublette",1998,"21 to 24","197","0","2","0","199"
"Sublette",1998,"25 & over","3871","2","17","2","3892"
"Sublette",1998,"Total","5740","2","27","4","5773"
"Hot Springs",2010,"0","43","2","1","0","46"
"Hot Springs",2010,"1","54","0","2","0","56"
"Hot Springs",2010,"2","52","0","2","0","54"
"Hot Springs",2010,"3","51","2","1","0","54"
"Hot Springs",2010,"4","50","0","0","0","50"
"Hot Springs",2010,"5","51","0","1","0","52"
"Hot Springs",2010,"6","44","0","0","0","44"
"Hot Springs",2010,"7","48","1","0","1","50"
"Hot Springs",2010,"8","56","1","1","0","58"
"Hot Springs",2010,"9","50","1","2","1","54"
"Hot Springs",2010,"10","51","0","1","0","52"
"Hot Springs",2010,"11","61","1","1","0","63"
"Hot Springs",2010,"12","57","0","0","1","58"
"Hot Springs",2010,"13","52","1","2","1","56"
"Hot Springs",2010,"14","57","3","0","1","61"
"Hot Springs",2010,"15","51","1","1","1","54"
"Hot Springs",2010,"16","43","2","2","0","47"
"Hot Springs",2010,"17","53","2","2","1","58"
"Hot Springs",2010,"18 to 20","115","1","4","1","121"
"Hot Springs",2010,"21 to 24","178","3","9","3","193"
"Hot Springs",2010,"25 & over","3467","10","43","12","3532"
"Hot Springs",2010,"Total","4684","31","75","23","4813"
"Teton",2012,"0","231","1","0","2","234"
"Teton",2012,"1","243","1","2","2","248"
"Teton",2012,"2","259","5","5","2","271"
"Teton",2012,"3","267","1","5","1","274"
"Teton",2012,"4","259","4","3","5","271"
"Teton",2012,"5","262","2","3","4","271"
"Teton",2012,"6","226","3","5","3","237"
"Teton",2012,"7","240","3","5","5","253"
"Teton",2012,"8","227","2","3","6","238"
"Teton",2012,"9","222","3","2","7","234"
"Teton",2012,"10","202","3","1","4","210"
"Teton",2012,"11","195","0","2","5","202"
"Teton",2012,"12","211","2","5","8","226"
"Teton",2012,"13","190","0","3","2","195"
"Teton",2012,"14","201","1","2","5","209"
"Teton",2012,"15","217","4","0","4","225"
"Teton",2012,"16","178","1","3","3","185"
"Teton",2012,"17","202","4","2","6","214"
"Teton",2012,"18 to 20","486","23","5","4","518"
"Teton",2012,"21 to 24","848","13","14","23","898"
"Teton",2012,"25 & over","15541","167","158","209","16075"
"Teton",2012,"Total","20907","243","228","310","21688"
"Teton",2003,"0","231","2","3","2","238"
"Teton",2003,"1","188","0","0","1","189"
"Teton",2003,"2","179","2","2","4","187"
"Teton",2003,"3","172","2","0","1","175"
"Teton",2003,"4","150","0","2","2","154"
"Teton",2003,"5","170","2","2","4","178"
"Teton",2003,"6","190","2","0","1","193"
"Teton",2003,"7","172","2","1","1","176"
"Teton",2003,"8","181","1","1","2","185"
"Teton",2003,"9","199","1","0","2","202"
"Teton",2003,"10","192","1","1","2","196"
"Teton",2003,"11","198","1","1","2","202"
"Teton",2003,"12","226","1","0","3","230"
"Teton",2003,"13","228","1","0","1","230"
"Teton",2003,"14","225","0","1","2","228"
"Teton",2003,"15","221","0","2","0","223"
"Teton",2003,"16","234","0","1","1","236"
"Teton",2003,"17","213","1","1","1","216"
"Teton",2003,"18 to 20","559","2","3","7","571"
"Teton",2003,"21 to 24","1138","6","9","14","1167"
"Teton",2003,"25 & over","13442","35","95","118","13690"
"Teton",2003,"Total","18708","62","125","171","19066"
"Teton",2002,"0","218","2","4","3","227"
"Teton",2002,"1","188","1","0","1","190"
"Teton",2002,"2","172","2","1","3","178"
"Teton",2002,"3","167","2","0","3","172"
"Teton",2002,"4","166","0","3","2","171"
"Teton",2002,"5","178","2","1","3","184"
"Teton",2002,"6","164","2","0","2","168"
"Teton",2002,"7","182","3","1","1","187"
"Teton",2002,"8","184","1","2","1","188"
"Teton",2002,"9","169","1","0","2","172"
"Teton",2002,"10","204","1","1","2","208"
"Teton",2002,"11","208","1","1","2","212"
"Teton",2002,"12","226","1","0","2","229"
"Teton",2002,"13","237","0","0","1","238"
"Teton",2002,"14","203","0","2","3","208"
"Teton",2002,"15","232","0","2","0","234"
"Teton",2002,"16","218","0","2","1","221"
"Teton",2002,"17","231","2","1","2","236"
"Teton",2002,"18 to 20","532","2","3","5","542"
"Teton",2002,"21 to 24","1135","4","7","17","1163"
"Teton",2002,"25 & over","13270","30","94","115","13509"
"Teton",2002,"Total","18484","57","125","171","18837"
"Sublette",2004,"0","82","1","1","0","84"
"Sublette",2004,"1","85","1","2","0","88"
"Sublette",2004,"2","76","1","0","1","78"
"Sublette",2004,"3","64","1","1","0","66"
"Sublette",2004,"4","70","0","2","1","73"
"Sublette",2004,"5","93","0","0","0","93"
"Sublette",2004,"6","85","0","1","1","87"
"Sublette",2004,"7","98","0","0","0","98"
"Sublette",2004,"8","84","0","1","0","85"
"Sublette",2004,"9","71","1","1","0","73"
"Sublette",2004,"10","102","0","2","0","104"
"Sublette",2004,"11","88","1","1","1","91"
"Sublette",2004,"12","86","0","3","0","89"
"Sublette",2004,"13","89","1","1","0","91"
"Sublette",2004,"14","110","0","1","0","111"
"Sublette",2004,"15","113","1","2","2","118"
"Sublette",2004,"16","101","0","2","0","103"
"Sublette",2004,"17","96","0","1","0","97"
"Sublette",2004,"18 to 20","226","2","1","1","230"
"Sublette",2004,"21 to 24","277","1","3","5","286"
"Sublette",2004,"25 & over","4841","27","39","20","4927"
"Sublette",2004,"Total","6937","38","65","32","7072"
"Sheridan",2003,"0","318","3","6","1","328"
"Sheridan",2003,"1","278","2","8","3","291"
"Sheridan",2003,"2","286","1","11","2","300"
"Sheridan",2003,"3","335","2","9","2","348"
"Sheridan",2003,"4","249","1","5","1","256"
"Sheridan",2003,"5","284","1","3","3","291"
"Sheridan",2003,"6","290","3","10","1","304"
"Sheridan",2003,"7","277","2","9","1","289"
"Sheridan",2003,"8","291","3","5","2","301"
"Sheridan",2003,"9","321","2","7","2","332"
"Sheridan",2003,"10","366","2","5","2","375"
"Sheridan",2003,"11","303","3","9","1","316"
"Sheridan",2003,"12","331","2","9","0","342"
"Sheridan",2003,"13","375","4","9","1","389"
"Sheridan",2003,"14","380","0","14","5","399"
"Sheridan",2003,"15","403","4","12","4","423"
"Sheridan",2003,"16","387","3","14","2","406"
"Sheridan",2003,"17","429","2","11","3","445"
"Sheridan",2003,"18 to 20","1104","12","25","7","1148"
"Sheridan",2003,"21 to 24","1207","8","27","11","1253"
"Sheridan",2003,"25 & over","18030","37","234","101","18402"
"Sheridan",2003,"Total","26244","97","442","155","26938"
"Campbell",1991,"0","468","0","9","2","479"
"Campbell",1991,"1","521","4","9","2","536"
"Campbell",1991,"2","520","1","7","0","528"
"Campbell",1991,"3","523","0","7","0","530"
"Campbell",1991,"4","571","2","7","0","580"
"Campbell",1991,"5","595","0","8","0","603"
"Campbell",1991,"6","634","0","4","2","640"
"Campbell",1991,"7","622","0","12","0","634"
"Campbell",1991,"8","619","1","7","1","628"
"Campbell",1991,"9","652","0","13","6","671"
"Campbell",1991,"10","663","4","11","6","684"
"Campbell",1991,"11","625","0","9","0","634"
"Campbell",1991,"12","633","0","18","3","654"
"Campbell",1991,"13","600","0","8","2","610"
"Campbell",1991,"14","587","0","3","0","590"
"Campbell",1991,"15","546","1","6","6","559"
"Campbell",1991,"16","537","4","4","2","547"
"Campbell",1991,"17","509","2","9","2","522"
"Campbell",1991,"18 to 20","1024","1","14","0","1039"
"Campbell",1991,"21 to 24","1158","4","28","6","1196"
"Campbell",1991,"25 & over","16749","12","155","46","16962"
"Campbell",1991,"Total","29356","36","348","86","29826"
"Lincoln",2013,"0","227","1","8","1","237"
"Lincoln",2013,"1","239","1","6","0","246"
"Lincoln",2013,"2","246","2","0","0","248"
"Lincoln",2013,"3","278","1","1","1","281"
"Lincoln",2013,"4","280","2","1","0","283"
"Lincoln",2013,"5","297","2","4","1","304"
"Lincoln",2013,"6","314","3","2","1","320"
"Lincoln",2013,"7","287","4","1","2","294"
"Lincoln",2013,"8","284","3","5","3","295"
"Lincoln",2013,"9","264","2","4","1","271"
"Lincoln",2013,"10","274","1","5","1","281"
"Lincoln",2013,"11","262","5","4","0","271"
"Lincoln",2013,"12","259","4","3","0","266"
"Lincoln",2013,"13","277","4","2","1","284"
"Lincoln",2013,"14","271","4","3","0","278"
"Lincoln",2013,"15","278","0","3","2","283"
"Lincoln",2013,"16","259","3","3","3","268"
"Lincoln",2013,"17","265","2","3","1","271"
"Lincoln",2013,"18 to 20","569","15","13","4","601"
"Lincoln",2013,"21 to 24","550","4","11","0","565"
"Lincoln",2013,"25 & over","11868","131","110","71","12180"
"Lincoln",2013,"Total","17848","194","192","93","18327"
"Hot Springs",2011,"0","52","2","1","0","55"
"Hot Springs",2011,"1","36","1","3","0","40"
"Hot Springs",2011,"2","51","1","2","0","54"
"Hot Springs",2011,"3","48","0","3","0","51"
"Hot Springs",2011,"4","65","1","3","0","69"
"Hot Springs",2011,"5","48","0","0","0","48"
"Hot Springs",2011,"6","47","0","1","0","48"
"Hot Springs",2011,"7","47","1","0","0","48"
"Hot Springs",2011,"8","43","1","1","1","46"
"Hot Springs",2011,"9","62","1","2","0","65"
"Hot Springs",2011,"10","46","0","1","1","48"
"Hot Springs",2011,"11","60","0","1","1","62"
"Hot Springs",2011,"12","53","2","1","0","56"
"Hot Springs",2011,"13","57","1","0","1","59"
"Hot Springs",2011,"14","52","0","2","1","55"
"Hot Springs",2011,"15","52","3","0","1","56"
"Hot Springs",2011,"16","49","0","1","1","51"
"Hot Springs",2011,"17","40","2","2","0","44"
"Hot Springs",2011,"18 to 20","122","2","2","3","129"
"Hot Springs",2011,"21 to 24","166","3","10","3","182"
"Hot Springs",2011,"25 & over","3479","15","46","13","3553"
"Hot Springs",2011,"Total","4675","36","82","26","4819"
"Albany",1992,"0","357","4","4","14","379"
"Albany",1992,"1","345","12","6","13","376"
"Albany",1992,"2","372","5","7","11","395"
"Albany",1992,"3","356","0","6","6","368"
"Albany",1992,"4","342","6","2","11","361"
"Albany",1992,"5","350","5","2","5","362"
"Albany",1992,"6","350","4","7","3","364"
"Albany",1992,"7","360","5","5","8","378"
"Albany",1992,"8","355","12","4","2","373"
"Albany",1992,"9","384","4","9","6","403"
"Albany",1992,"10","385","2","5","1","393"
"Albany",1992,"11","364","2","3","8","377"
"Albany",1992,"12","366","8","4","10","388"
"Albany",1992,"13","344","5","10","6","365"
"Albany",1992,"14","324","0","6","2","332"
"Albany",1992,"15","326","3","9","4","342"
"Albany",1992,"16","336","0","4","2","342"
"Albany",1992,"17","338","7","1","5","351"
"Albany",1992,"18 to 20","3877","59","24","50","4010"
"Albany",1992,"21 to 24","4265","41","30","123","4459"
"Albany",1992,"25 & over","15893","105","110","340","16448"
"Albany",1992,"Total","30389","289","258","630","31566"
"Natrona",1997,"0","834","5","8","4","851"
"Natrona",1997,"1","882","11","6","9","908"
"Natrona",1997,"2","805","11","12","2","830"
"Natrona",1997,"3","860","16","15","8","899"
"Natrona",1997,"4","873","15","10","4","902"
"Natrona",1997,"5","892","16","12","4","924"
"Natrona",1997,"6","919","8","13","1","941"
"Natrona",1997,"7","947","21","8","7","983"
"Natrona",1997,"8","947","8","11","3","969"
"Natrona",1997,"9","929","16","16","10","971"
"Natrona",1997,"10","1046","22","13","4","1085"
"Natrona",1997,"11","1020","12","7","4","1043"
"Natrona",1997,"12","1061","10","18","8","1097"
"Natrona",1997,"13","1049","14","14","9","1086"
"Natrona",1997,"14","1067","10","22","4","1103"
"Natrona",1997,"15","1143","11","18","7","1179"
"Natrona",1997,"16","1054","7","10","5","1076"
"Natrona",1997,"17","1121","14","8","5","1148"
"Natrona",1997,"18 to 20","3130","43","33","22","3228"
"Natrona",1997,"21 to 24","3180","34","40","23","3277"
"Natrona",1997,"25 & over","41019","258","366","169","41812"
"Natrona",1997,"Total","64778","562","660","312","66312"
"Campbell",1992,"0","465","0","9","4","478"
"Campbell",1992,"1","504","2","10","2","518"
"Campbell",1992,"2","542","1","7","0","550"
"Campbell",1992,"3","522","0","7","0","529"
"Campbell",1992,"4","546","3","7","0","556"
"Campbell",1992,"5","575","0","10","0","585"
"Campbell",1992,"6","610","0","4","2","616"
"Campbell",1992,"7","628","0","11","0","639"
"Campbell",1992,"8","601","2","6","1","610"
"Campbell",1992,"9","654","0","13","6","673"
"Campbell",1992,"10","674","4","11","5","694"
"Campbell",1992,"11","627","0","9","0","636"
"Campbell",1992,"12","678","0","19","3","700"
"Campbell",1992,"13","630","0","7","2","639"
"Campbell",1992,"14","611","0","6","0","617"
"Campbell",1992,"15","594","1","7","6","608"
"Campbell",1992,"16","547","4","5","2","558"
"Campbell",1992,"17","549","2","8","2","561"
"Campbell",1992,"18 to 20","1074","1","13","0","1088"
"Campbell",1992,"21 to 24","1248","4","30","9","1291"
"Campbell",1992,"25 & over","17154","15","153","49","17371"
"Campbell",1992,"Total","30033","39","352","93","30517"
"Converse",1994,"0","156","0","0","0","156"
"Converse",1994,"1","144","1","4","0","149"
"Converse",1994,"2","151","2","0","0","153"
"Converse",1994,"3","165","0","0","0","165"
"Converse",1994,"4","182","0","4","0","186"
"Converse",1994,"5","187","2","2","2","193"
"Converse",1994,"6","162","0","0","0","162"
"Converse",1994,"7","188","2","2","0","192"
"Converse",1994,"8","195","0","0","0","195"
"Converse",1994,"9","228","0","6","1","235"
"Converse",1994,"10","208","0","0","2","210"
"Converse",1994,"11","222","0","2","0","224"
"Converse",1994,"12","229","0","5","0","234"
"Converse",1994,"13","232","0","0","0","232"
"Converse",1994,"14","254","3","7","2","266"
"Converse",1994,"15","220","1","0","1","222"
"Converse",1994,"16","204","0","4","0","208"
"Converse",1994,"17","241","0","2","0","243"
"Converse",1994,"18 to 20","371","0","5","0","376"
"Converse",1994,"21 to 24","421","0","5","0","426"
"Converse",1994,"25 & over","7000","4","49","12","7065"
"Converse",1994,"Total","11360","15","97","20","11492"
"Carbon",2013,"0","184","4","10","1","199"
"Carbon",2013,"1","195","1","2","0","198"
"Carbon",2013,"2","209","4","4","4","221"
"Carbon",2013,"3","204","6","5","1","216"
"Carbon",2013,"4","206","1","2","0","209"
"Carbon",2013,"5","221","5","3","3","232"
"Carbon",2013,"6","216","3","1","2","222"
"Carbon",2013,"7","195","6","3","2","206"
"Carbon",2013,"8","185","4","6","4","199"
"Carbon",2013,"9","197","5","2","1","205"
"Carbon",2013,"10","201","2","1","2","206"
"Carbon",2013,"11","188","2","6","2","198"
"Carbon",2013,"12","194","1","8","2","205"
"Carbon",2013,"13","190","5","4","1","200"
"Carbon",2013,"14","207","3","5","3","218"
"Carbon",2013,"15","191","2","2","1","196"
"Carbon",2013,"16","188","1","3","2","194"
"Carbon",2013,"17","171","1","3","2","177"
"Carbon",2013,"18 to 20","470","12","14","4","500"
"Carbon",2013,"21 to 24","751","21","21","15","808"
"Carbon",2013,"25 & over","10295","195","188","112","10790"
"Carbon",2013,"Total","15058","284","293","164","15799"
"Albany",1994,"0","351","4","3","9","367"
"Albany",1994,"1","335","12","4","18","369"
"Albany",1994,"2","350","3","6","12","371"
"Albany",1994,"3","344","0","6","4","354"
"Albany",1994,"4","350","7","4","8","369"
"Albany",1994,"5","342","5","3","9","359"
"Albany",1994,"6","317","6","6","3","332"
"Albany",1994,"7","346","7","6","5","364"
"Albany",1994,"8","342","8","3","2","355"
"Albany",1994,"9","374","5","7","8","394"
"Albany",1994,"10","376","6","5","2","389"
"Albany",1994,"11","361","5","4","7","377"
"Albany",1994,"12","368","6","1","10","385"
"Albany",1994,"13","369","5","9","6","389"
"Albany",1994,"14","361","0","7","4","372"
"Albany",1994,"15","353","4","8","4","369"
"Albany",1994,"16","359","0","7","2","368"
"Albany",1994,"17","366","6","1","4","377"
"Albany",1994,"18 to 20","3982","57","25","44","4108"
"Albany",1994,"21 to 24","4620","48","35","129","4832"
"Albany",1994,"25 & over","16342","108","132","344","16926"
"Albany",1994,"Total","31308","302","282","634","32526"
"Platte",2012,"0","88","2","1","0","91"
"Platte",2012,"1","95","2","0","0","97"
"Platte",2012,"2","74","1","1","1","77"
"Platte",2012,"3","80","1","2","0","83"
"Platte",2012,"4","93","1","2","0","96"
"Platte",2012,"5","101","2","1","2","106"
"Platte",2012,"6","83","2","0","1","86"
"Platte",2012,"7","99","2","0","0","101"
"Platte",2012,"8","84","2","0","0","86"
"Platte",2012,"9","86","2","1","0","89"
"Platte",2012,"10","104","1","2","0","107"
"Platte",2012,"11","91","0","0","0","91"
"Platte",2012,"12","89","0","3","4","96"
"Platte",2012,"13","92","0","0","0","92"
"Platte",2012,"14","102","1","2","0","105"
"Platte",2012,"15","104","3","1","1","109"
"Platte",2012,"16","94","1","2","2","99"
"Platte",2012,"17","119","2","1","2","124"
"Platte",2012,"18 to 20","270","2","6","8","286"
"Platte",2012,"21 to 24","270","5","2","5","282"
"Platte",2012,"25 & over","6320","42","43","28","6433"
"Platte",2012,"Total","8538","74","70","54","8736"
"Albany",2010,"0","406","10","5","13","434"
"Albany",2010,"1","396","13","5","13","427"
"Albany",2010,"2","379","16","7","12","414"
"Albany",2010,"3","374","14","7","7","402"
"Albany",2010,"4","337","12","8","10","367"
"Albany",2010,"5","326","8","7","9","350"
"Albany",2010,"6","302","10","5","9","326"
"Albany",2010,"7","291","8","4","7","310"
"Albany",2010,"8","284","9","8","10","311"
"Albany",2010,"9","289","8","2","8","307"
"Albany",2010,"10","263","10","6","5","284"
"Albany",2010,"11","240","8","4","7","259"
"Albany",2010,"12","269","10","1","9","289"
"Albany",2010,"13","294","6","2","12","314"
"Albany",2010,"14","282","4","3","9","298"
"Albany",2010,"15","298","5","4","6","313"
"Albany",2010,"16","294","6","3","8","311"
"Albany",2010,"17","305","12","7","7","331"
"Albany",2010,"18 to 20","4379","86","34","113","4612"
"Albany",2010,"21 to 24","5501","144","93","252","5990"
"Albany",2010,"25 & over","18724","224","205","626","19779"
"Albany",2010,"Total","34233","623","420","1152","36428"
"Laramie",2007,"0","1210","69","35","16","1330"
"Laramie",2007,"1","1180","103","30","19","1332"
"Laramie",2007,"2","1167","65","21","38","1291"
"Laramie",2007,"3","1091","76","14","24","1205"
"Laramie",2007,"4","1050","56","28","17","1151"
"Laramie",2007,"5","1103","60","24","17","1204"
"Laramie",2007,"6","1072","53","24","25","1174"
"Laramie",2007,"7","1019","55","20","29","1123"
"Laramie",2007,"8","1025","32","20","17","1094"
"Laramie",2007,"9","1049","55","20","20","1144"
"Laramie",2007,"10","1039","39","28","11","1117"
"Laramie",2007,"11","1057","50","40","12","1159"
"Laramie",2007,"12","1044","41","25","12","1122"
"Laramie",2007,"13","1124","45","7","17","1193"
"Laramie",2007,"14","1132","57","15","26","1230"
"Laramie",2007,"15","1114","54","19","13","1200"
"Laramie",2007,"16","1145","42","16","31","1234"
"Laramie",2007,"17","1135","32","11","19","1197"
"Laramie",2007,"18 to 20","3163","184","48","59","3454"
"Laramie",2007,"21 to 24","4998","360","90","106","5554"
"Laramie",2007,"25 & over","54331","1327","638","850","57146"
"Laramie",2007,"Total","82248","2855","1173","1378","87654"
"Washakie",1994,"0","99","0","0","1","100"
"Washakie",1994,"1","101","0","2","0","103"
"Washakie",1994,"2","107","0","0","1","108"
"Washakie",1994,"3","102","0","0","0","102"
"Washakie",1994,"4","108","0","0","0","108"
"Washakie",1994,"5","112","2","5","1","120"
"Washakie",1994,"6","109","0","0","1","110"
"Washakie",1994,"7","120","0","0","0","120"
"Washakie",1994,"8","143","0","0","0","143"
"Washakie",1994,"9","157","0","0","0","157"
"Washakie",1994,"10","162","0","0","1","163"
"Washakie",1994,"11","167","0","0","0","167"
"Washakie",1994,"12","152","0","2","1","155"
"Washakie",1994,"13","162","0","3","0","165"
"Washakie",1994,"14","172","0","1","0","173"
"Washakie",1994,"15","176","0","5","0","181"
"Washakie",1994,"16","163","0","0","0","163"
"Washakie",1994,"17","147","0","0","1","148"
"Washakie",1994,"18 to 20","266","1","1","0","268"
"Washakie",1994,"21 to 24","280","0","0","0","280"
"Washakie",1994,"25 & over","5407","1","20","22","5450"
"Washakie",1994,"Total","8412","4","39","29","8484"
"Johnson",2001,"0","62","1","1","0","64"
"Johnson",2001,"1","59","0","0","0","59"
"Johnson",2001,"2","74","0","0","0","74"
"Johnson",2001,"3","67","0","0","0","67"
"Johnson",2001,"4","79","0","0","1","80"
"Johnson",2001,"5","83","0","1","0","84"
"Johnson",2001,"6","93","1","1","0","95"
"Johnson",2001,"7","89","0","3","0","92"
"Johnson",2001,"8","97","2","2","1","102"
"Johnson",2001,"9","96","0","2","0","98"
"Johnson",2001,"10","104","0","2","0","106"
"Johnson",2001,"11","107","0","0","0","107"
"Johnson",2001,"12","102","0","1","0","103"
"Johnson",2001,"13","92","0","1","0","93"
"Johnson",2001,"14","102","0","3","0","105"
"Johnson",2001,"15","120","0","0","1","121"
"Johnson",2001,"16","106","0","0","0","106"
"Johnson",2001,"17","120","0","0","0","120"
"Johnson",2001,"18 to 20","258","0","3","3","264"
"Johnson",2001,"21 to 24","177","2","1","0","180"
"Johnson",2001,"25 & over","5013","4","26","4","5047"
"Johnson",2001,"Total","7100","10","47","10","7167"
"Lincoln",2014,"0","238","1","7","1","247"
"Lincoln",2014,"1","234","0","10","1","245"
"Lincoln",2014,"2","254","1","5","2","262"
"Lincoln",2014,"3","240","0","0","2","242"
"Lincoln",2014,"4","283","1","4","2","290"
"Lincoln",2014,"5","291","1","3","0","295"
"Lincoln",2014,"6","295","1","5","1","302"
"Lincoln",2014,"7","306","3","3","1","313"
"Lincoln",2014,"8","300","2","1","1","304"
"Lincoln",2014,"9","295","1","4","3","303"
"Lincoln",2014,"10","268","4","4","0","276"
"Lincoln",2014,"11","276","0","5","2","283"
"Lincoln",2014,"12","259","5","4","0","268"
"Lincoln",2014,"13","271","3","4","1","279"
"Lincoln",2014,"14","286","5","2","2","295"
"Lincoln",2014,"15","275","3","3","0","281"
"Lincoln",2014,"16","291","1","1","2","295"
"Lincoln",2014,"17","273","2","3","2","280"
"Lincoln",2014,"18 to 20","607","22","12","7","648"
"Lincoln",2014,"21 to 24","602","12","10","0","624"
"Lincoln",2014,"25 & over","11959","101","110","78","12248"
"Lincoln",2014,"Total","18103","169","200","108","18580"
"Big Horn",1998,"0","158","0","0","0","158"
"Big Horn",1998,"1","157","0","3","0","160"
"Big Horn",1998,"2","168","0","0","0","168"
"Big Horn",1998,"3","147","0","0","0","147"
"Big Horn",1998,"4","160","0","4","0","164"
"Big Horn",1998,"5","171","0","5","2","178"
"Big Horn",1998,"6","172","0","0","0","172"
"Big Horn",1998,"7","167","0","0","0","167"
"Big Horn",1998,"8","189","0","0","0","189"
"Big Horn",1998,"9","204","0","0","0","204"
"Big Horn",1998,"10","181","0","6","2","189"
"Big Horn",1998,"11","181","0","1","0","182"
"Big Horn",1998,"12","232","0","4","0","236"
"Big Horn",1998,"13","217","0","0","0","217"
"Big Horn",1998,"14","206","0","0","1","207"
"Big Horn",1998,"15","194","0","5","0","199"
"Big Horn",1998,"16","240","0","0","0","240"
"Big Horn",1998,"17","222","0","2","2","226"
"Big Horn",1998,"18 to 20","429","0","7","0","436"
"Big Horn",1998,"21 to 24","409","0","0","0","409"
"Big Horn",1998,"25 & over","7222","0","37","13","7272"
"Big Horn",1998,"Total","11426","0","74","20","11520"
"Johnson",1993,"0","65","0","1","0","66"
"Johnson",1993,"1","77","0","0","0","77"
"Johnson",1993,"2","70","0","0","0","70"
"Johnson",1993,"3","73","0","0","0","73"
"Johnson",1993,"4","76","0","0","0","76"
"Johnson",1993,"5","77","0","1","0","78"
"Johnson",1993,"6","81","0","3","0","84"
"Johnson",1993,"7","88","0","0","0","88"
"Johnson",1993,"8","90","0","4","0","94"
"Johnson",1993,"9","100","0","1","0","101"
"Johnson",1993,"10","110","0","1","0","111"
"Johnson",1993,"11","112","0","0","0","112"
"Johnson",1993,"12","99","0","0","0","99"
"Johnson",1993,"13","97","0","3","0","100"
"Johnson",1993,"14","104","0","5","0","109"
"Johnson",1993,"15","99","0","2","1","102"
"Johnson",1993,"16","114","0","0","0","114"
"Johnson",1993,"17","102","0","0","0","102"
"Johnson",1993,"18 to 20","198","0","0","0","198"
"Johnson",1993,"21 to 24","192","0","0","0","192"
"Johnson",1993,"25 & over","4299","0","12","0","4311"
"Johnson",1993,"Total","6323","0","33","1","6357"
"Sheridan",2010,"0","343","7","4","0","354"
"Sheridan",2010,"1","331","4","6","1","342"
"Sheridan",2010,"2","375","4","9","3","391"
"Sheridan",2010,"3","380","5","8","4","397"
"Sheridan",2010,"4","365","3","8","2","378"
"Sheridan",2010,"5","331","4","7","4","346"
"Sheridan",2010,"6","333","1","7","2","343"
"Sheridan",2010,"7","376","3","6","3","388"
"Sheridan",2010,"8","338","2","7","2","349"
"Sheridan",2010,"9","322","2","8","2","334"
"Sheridan",2010,"10","357","3","10","2","372"
"Sheridan",2010,"11","332","4","9","2","347"
"Sheridan",2010,"12","328","2","9","1","340"
"Sheridan",2010,"13","336","3","6","1","346"
"Sheridan",2010,"14","307","1","9","2","319"
"Sheridan",2010,"15","328","6","12","4","350"
"Sheridan",2010,"16","356","4","13","4","377"
"Sheridan",2010,"17","389","5","11","1","406"
"Sheridan",2010,"18 to 20","1046","18","30","16","1110"
"Sheridan",2010,"21 to 24","1165","17","18","19","1219"
"Sheridan",2010,"25 & over","19876","70","238","154","20338"
"Sheridan",2010,"Total","28314","168","435","229","29146"
"Hot Springs",1991,"0","51","0","0","0","51"
"Hot Springs",1991,"1","37","0","1","0","38"
"Hot Springs",1991,"2","46","0","5","0","51"
"Hot Springs",1991,"3","48","0","0","0","48"
"Hot Springs",1991,"4","50","0","1","0","51"
"Hot Springs",1991,"5","63","0","2","0","65"
"Hot Springs",1991,"6","61","0","6","0","67"
"Hot Springs",1991,"7","55","0","1","0","56"
"Hot Springs",1991,"8","68","0","4","0","72"
"Hot Springs",1991,"9","81","0","1","0","82"
"Hot Springs",1991,"10","76","0","2","0","78"
"Hot Springs",1991,"11","77","0","2","0","79"
"Hot Springs",1991,"12","79","0","6","0","85"
"Hot Springs",1991,"13","80","0","1","0","81"
"Hot Springs",1991,"14","87","0","4","0","91"
"Hot Springs",1991,"15","73","0","2","0","75"
"Hot Springs",1991,"16","74","0","1","0","75"
"Hot Springs",1991,"17","76","0","2","0","78"
"Hot Springs",1991,"18 to 20","123","1","4","0","128"
"Hot Springs",1991,"21 to 24","116","0","1","0","117"
"Hot Springs",1991,"25 & over","3227","0","41","0","3268"
"Hot Springs",1991,"Total","4648","1","87","0","4736"
"Laramie",2005,"0","1116","66","32","18","1232"
"Laramie",2005,"1","1137","77","22","25","1261"
"Laramie",2005,"2","1054","64","12","21","1151"
"Laramie",2005,"3","1071","67","22","28","1188"
"Laramie",2005,"4","982","56","33","18","1089"
"Laramie",2005,"5","1050","70","13","18","1151"
"Laramie",2005,"6","1043","33","17","30","1123"
"Laramie",2005,"7","1005","55","22","23","1105"
"Laramie",2005,"8","1025","41","16","9","1091"
"Laramie",2005,"9","1013","41","22","11","1087"
"Laramie",2005,"10","1073","43","30","16","1162"
"Laramie",2005,"11","1131","61","29","9","1230"
"Laramie",2005,"12","1133","44","25","23","1225"
"Laramie",2005,"13","1137","50","10","10","1207"
"Laramie",2005,"14","1147","57","14","22","1240"
"Laramie",2005,"15","1145","27","16","13","1201"
"Laramie",2005,"16","1141","42","19","15","1217"
"Laramie",2005,"17","1070","35","17","24","1146"
"Laramie",2005,"18 to 20","3388","207","50","64","3709"
"Laramie",2005,"21 to 24","4852","287","75","98","5312"
"Laramie",2005,"25 & over","53024","1234","625","722","55605"
"Laramie",2005,"Total","80737","2657","1121","1217","85732"
"Johnson",2000,"0","63","1","1","0","65"
"Johnson",2000,"1","80","0","0","0","80"
"Johnson",2000,"2","66","0","0","0","66"
"Johnson",2000,"3","81","0","0","0","81"
"Johnson",2000,"4","73","0","0","1","74"
"Johnson",2000,"5","84","0","1","0","85"
"Johnson",2000,"6","86","1","1","0","88"
"Johnson",2000,"7","95","0","3","0","98"
"Johnson",2000,"8","92","2","2","1","97"
"Johnson",2000,"9","96","0","3","0","99"
"Johnson",2000,"10","106","0","2","0","108"
"Johnson",2000,"11","102","0","0","0","102"
"Johnson",2000,"12","94","0","1","0","95"
"Johnson",2000,"13","90","0","1","0","91"
"Johnson",2000,"14","115","0","3","0","118"
"Johnson",2000,"15","113","0","0","1","114"
"Johnson",2000,"16","113","0","0","0","113"
"Johnson",2000,"17","145","0","1","0","146"
"Johnson",2000,"18 to 20","193","0","3","3","199"
"Johnson",2000,"21 to 24","188","2","1","0","191"
"Johnson",2000,"25 & over","4961","5","28","4","4998"
"Johnson",2000,"Total","7036","11","51","10","7108"
"Weston",2010,"0","85","0","4","1","90"
"Weston",2010,"1","85","1","0","0","86"
"Weston",2010,"2","76","1","0","1","78"
"Weston",2010,"3","69","2","1","0","72"
"Weston",2010,"4","82","3","1","0","86"
"Weston",2010,"5","101","1","2","0","104"
"Weston",2010,"6","100","2","2","0","104"
"Weston",2010,"7","82","1","2","1","86"
"Weston",2010,"8","79","1","2","2","84"
"Weston",2010,"9","88","1","0","0","89"
"Weston",2010,"10","79","3","0","1","83"
"Weston",2010,"11","80","1","3","0","84"
"Weston",2010,"12","81","0","3","0","84"
"Weston",2010,"13","94","2","4","0","100"
"Weston",2010,"14","79","0","1","0","80"
"Weston",2010,"15","85","1","1","0","87"
"Weston",2010,"16","92","0","3","0","95"
"Weston",2010,"17","81","0","1","0","82"
"Weston",2010,"18 to 20","199","3","6","1","209"
"Weston",2010,"21 to 24","314","3","2","2","321"
"Weston",2010,"25 & over","4970","22","68","18","5078"
"Weston",2010,"Total","7001","48","106","27","7182"
"Teton",1993,"0","187","0","2","2","191"
"Teton",1993,"1","185","3","0","2","190"
"Teton",1993,"2","179","0","3","0","182"
"Teton",1993,"3","189","0","0","1","190"
"Teton",1993,"4","171","0","2","0","173"
"Teton",1993,"5","164","0","3","0","167"
"Teton",1993,"6","158","0","0","0","158"
"Teton",1993,"7","169","3","2","0","174"
"Teton",1993,"8","179","0","0","3","182"
"Teton",1993,"9","179","1","0","0","180"
"Teton",1993,"10","190","1","3","0","194"
"Teton",1993,"11","178","0","0","0","178"
"Teton",1993,"12","174","0","0","0","174"
"Teton",1993,"13","194","0","0","0","194"
"Teton",1993,"14","171","0","4","2","177"
"Teton",1993,"15","148","1","2","2","153"
"Teton",1993,"16","159","0","2","0","161"
"Teton",1993,"17","149","0","0","0","149"
"Teton",1993,"18 to 20","373","1","6","0","380"
"Teton",1993,"21 to 24","768","3","5","9","785"
"Teton",1993,"25 & over","9301","7","62","31","9401"
"Teton",1993,"Total","13565","20","96","52","13733"
"Goshen",2004,"0","124","1","3","1","129"
"Goshen",2004,"1","139","2","2","2","145"
"Goshen",2004,"2","146","2","1","1","150"
"Goshen",2004,"3","148","1","2","0","151"
"Goshen",2004,"4","139","1","0","2","142"
"Goshen",2004,"5","139","1","2","0","142"
"Goshen",2004,"6","149","1","3","2","155"
"Goshen",2004,"7","118","0","2","0","120"
"Goshen",2004,"8","128","1","2","0","131"
"Goshen",2004,"9","137","0","3","0","140"
"Goshen",2004,"10","175","3","0","1","179"
"Goshen",2004,"11","124","1","3","0","128"
"Goshen",2004,"12","178","1","5","2","186"
"Goshen",2004,"13","190","2","3","0","195"
"Goshen",2004,"14","185","1","3","2","191"
"Goshen",2004,"15","147","2","2","0","151"
"Goshen",2004,"16","179","1","2","1","183"
"Goshen",2004,"17","175","0","3","0","178"
"Goshen",2004,"18 to 20","606","7","7","7","627"
"Goshen",2004,"21 to 24","582","3","5","3","593"
"Goshen",2004,"25 & over","8354","19","64","20","8457"
"Goshen",2004,"Total","12262","50","117","44","12473"
"Weston",2012,"0","71","2","2","0","75"
"Weston",2012,"1","83","0","1","0","84"
"Weston",2012,"2","79","2","1","1","83"
"Weston",2012,"3","91","2","3","0","96"
"Weston",2012,"4","70","3","1","0","74"
"Weston",2012,"5","63","3","3","0","69"
"Weston",2012,"6","90","3","3","0","96"
"Weston",2012,"7","96","1","2","0","99"
"Weston",2012,"8","99","0","2","0","101"
"Weston",2012,"9","85","2","4","1","92"
"Weston",2012,"10","73","1","2","1","77"
"Weston",2012,"11","85","1","1","0","87"
"Weston",2012,"12","70","2","2","1","75"
"Weston",2012,"13","78","2","3","0","83"
"Weston",2012,"14","89","1","2","0","92"
"Weston",2012,"15","88","2","3","0","93"
"Weston",2012,"16","71","1","2","0","74"
"Weston",2012,"17","85","1","1","1","88"
"Weston",2012,"18 to 20","203","8","6","1","218"
"Weston",2012,"21 to 24","292","8","4","0","304"
"Weston",2012,"25 & over","4864","40","79","22","5005"
"Weston",2012,"Total","6825","85","127","28","7065"
"Laramie",2011,"0","1181","77","19","15","1292"
"Laramie",2011,"1","1189","61","23","15","1288"
"Laramie",2011,"2","1195","65","20","20","1300"
"Laramie",2011,"3","1268","71","24","24","1387"
"Laramie",2011,"4","1278","56","16","22","1372"
"Laramie",2011,"5","1212","70","22","24","1328"
"Laramie",2011,"6","1198","49","23","21","1291"
"Laramie",2011,"7","1217","44","21","26","1308"
"Laramie",2011,"8","1140","40","21","28","1229"
"Laramie",2011,"9","1102","43","20","21","1186"
"Laramie",2011,"10","1080","50","24","18","1172"
"Laramie",2011,"11","1128","45","18","17","1208"
"Laramie",2011,"12","1104","54","30","17","1205"
"Laramie",2011,"13","1067","57","33","21","1178"
"Laramie",2011,"14","1058","44","16","12","1130"
"Laramie",2011,"15","1052","49","20","25","1146"
"Laramie",2011,"16","1035","46","16","21","1118"
"Laramie",2011,"17","1111","49","28","18","1206"
"Laramie",2011,"18 to 20","3284","237","58","77","3656"
"Laramie",2011,"21 to 24","4736","266","77","116","5195"
"Laramie",2011,"25 & over","58417","1364","763","898","61442"
"Laramie",2011,"Total","87052","2837","1292","1456","92637"
"Crook",1990,"0","99","0","0","0","99"
"Crook",1990,"1","76","0","1","0","77"
"Crook",1990,"2","87","0","0","0","87"
"Crook",1990,"3","82","0","0","0","82"
"Crook",1990,"4","96","0","0","0","96"
"Crook",1990,"5","85","0","1","0","86"
"Crook",1990,"6","104","0","0","0","104"
"Crook",1990,"7","107","0","0","0","107"
"Crook",1990,"8","108","0","0","0","108"
"Crook",1990,"9","110","0","0","0","110"
"Crook",1990,"10","111","0","2","0","113"
"Crook",1990,"11","104","0","0","0","104"
"Crook",1990,"12","109","0","0","0","109"
"Crook",1990,"13","102","0","0","0","102"
"Crook",1990,"14","91","0","0","0","91"
"Crook",1990,"15","90","0","1","0","91"
"Crook",1990,"16","83","0","0","0","83"
"Crook",1990,"17","77","0","0","0","77"
"Crook",1990,"18 to 20","152","0","2","0","154"
"Crook",1990,"21 to 24","166","0","0","0","166"
"Crook",1990,"25 & over","3239","0","17","0","3256"
"Crook",1990,"Total","5278","0","24","0","5302"
"Big Horn",2016,"0","133","5","5","1","144"
"Big Horn",2016,"1","146","1","4","0","151"
"Big Horn",2016,"2","149","2","3","1","155"
"Big Horn",2016,"3","141","3","4","1","149"
"Big Horn",2016,"4","159","1","1","1","162"
"Big Horn",2016,"5","166","2","2","3","173"
"Big Horn",2016,"6","133","3","3","0","139"
"Big Horn",2016,"7","164","0","3","1","168"
"Big Horn",2016,"8","168","1","1","0","170"
"Big Horn",2016,"9","177","3","3","0","183"
"Big Horn",2016,"10","183","2","2","2","189"
"Big Horn",2016,"11","209","0","0","0","209"
"Big Horn",2016,"12","173","4","0","3","180"
"Big Horn",2016,"13","172","1","1","2","176"
"Big Horn",2016,"14","165","3","0","0","168"
"Big Horn",2016,"15","177","1","3","2","183"
"Big Horn",2016,"16","192","2","4","2","200"
"Big Horn",2016,"17","175","3","2","0","180"
"Big Horn",2016,"18 to 20","409","7","3","4","423"
"Big Horn",2016,"21 to 24","446","6","13","5","470"
"Big Horn",2016,"25 & over","7796","69","134","34","8033"
"Big Horn",2016,"Total","11633","119","191","62","12005"
"Uinta",2001,"0","284","1","4","0","289"
"Uinta",2001,"1","290","1","4","1","296"
"Uinta",2001,"2","319","1","2","0","322"
"Uinta",2001,"3","311","0","1","1","313"
"Uinta",2001,"4","291","5","2","2","300"
"Uinta",2001,"5","328","2","5","2","337"
"Uinta",2001,"6","272","1","2","2","277"
"Uinta",2001,"7","331","4","5","3","343"
"Uinta",2001,"8","298","2","4","1","305"
"Uinta",2001,"9","294","0","4","2","300"
"Uinta",2001,"10","347","2","6","2","357"
"Uinta",2001,"11","382","1","4","3","390"
"Uinta",2001,"12","359","1","5","1","366"
"Uinta",2001,"13","389","0","4","1","394"
"Uinta",2001,"14","379","0","6","1","386"
"Uinta",2001,"15","423","1","12","0","436"
"Uinta",2001,"16","406","0","4","2","412"
"Uinta",2001,"17","458","0","5","3","466"
"Uinta",2001,"18 to 20","900","2","18","2","922"
"Uinta",2001,"21 to 24","840","0","8","4","852"
"Uinta",2001,"25 & over","11177","16","107","50","11350"
"Uinta",2001,"Total","19078","40","212","83","19413"
"Albany",1997,"0","342","4","3","8","357"
"Albany",1997,"1","319","19","4","14","356"
"Albany",1997,"2","326","4","2","9","341"
"Albany",1997,"3","318","0","3","5","326"
"Albany",1997,"4","309","8","4","11","332"
"Albany",1997,"5","326","12","2","5","345"
"Albany",1997,"6","291","3","9","2","305"
"Albany",1997,"7","338","6","7","4","355"
"Albany",1997,"8","307","5","2","3","317"
"Albany",1997,"9","324","7","5","11","347"
"Albany",1997,"10","331","5","4","4","344"
"Albany",1997,"11","320","6","5","6","337"
"Albany",1997,"12","338","5","9","14","366"
"Albany",1997,"13","348","9","8","8","373"
"Albany",1997,"14","353","0","6","4","363"
"Albany",1997,"15","365","6","5","4","380"
"Albany",1997,"16","367","1","7","1","376"
"Albany",1997,"17","392","6","1","5","404"
"Albany",1997,"18 to 20","3970","57","36","40","4103"
"Albany",1997,"21 to 24","4613","68","40","109","4830"
"Albany",1997,"25 & over","16384","117","133","373","17007"
"Albany",1997,"Total","30981","348","295","640","32264"
"Fremont",1994,"0","316","0","142","1","459"
"Fremont",1994,"1","310","5","184","0","499"
"Fremont",1994,"2","337","0","190","3","530"
"Fremont",1994,"3","344","0","208","0","552"
"Fremont",1994,"4","366","0","181","4","551"
"Fremont",1994,"5","366","1","179","2","548"
"Fremont",1994,"6","392","0","168","0","560"
"Fremont",1994,"7","390","0","159","2","551"
"Fremont",1994,"8","411","0","164","1","576"
"Fremont",1994,"9","471","0","191","1","663"
"Fremont",1994,"10","426","2","162","6","596"
"Fremont",1994,"11","468","0","207","1","676"
"Fremont",1994,"12","489","0","171","0","660"
"Fremont",1994,"13","510","4","185","0","699"
"Fremont",1994,"14","520","0","184","0","704"
"Fremont",1994,"15","468","0","153","2","623"
"Fremont",1994,"16","466","3","137","2","608"
"Fremont",1994,"17","455","0","124","0","579"
"Fremont",1994,"18 to 20","972","2","333","2","1309"
"Fremont",1994,"21 to 24","1011","3","463","8","1485"
"Fremont",1994,"25 & over","18353","15","3083","49","21500"
"Fremont",1994,"Total","27841","35","6968","84","34928"
"Goshen",2009,"0","151","3","1","0","155"
"Goshen",2009,"1","113","2","1","2","118"
"Goshen",2009,"2","132","4","0","2","138"
"Goshen",2009,"3","139","3","2","0","144"
"Goshen",2009,"4","101","1","2","1","105"
"Goshen",2009,"5","150","1","0","0","151"
"Goshen",2009,"6","159","1","1","2","163"
"Goshen",2009,"7","120","1","3","1","125"
"Goshen",2009,"8","137","2","0","0","139"
"Goshen",2009,"9","146","1","3","1","151"
"Goshen",2009,"10","141","2","1","0","144"
"Goshen",2009,"11","145","0","1","0","146"
"Goshen",2009,"12","150","1","5","1","157"
"Goshen",2009,"13","155","2","2","2","161"
"Goshen",2009,"14","143","4","2","2","151"
"Goshen",2009,"15","162","4","2","0","168"
"Goshen",2009,"16","153","3","2","0","158"
"Goshen",2009,"17","179","2","4","0","185"
"Goshen",2009,"18 to 20","637","13","9","7","666"
"Goshen",2009,"21 to 24","571","12","8","1","592"
"Goshen",2009,"25 & over","8901","44","73","32","9050"
"Goshen",2009,"Total","12685","106","122","54","12967"
"Sheridan",2000,"0","290","3","6","1","300"
"Sheridan",2000,"1","244","2","6","3","255"
"Sheridan",2000,"2","285","1","5","0","291"
"Sheridan",2000,"3","295","2","2","0","299"
"Sheridan",2000,"4","253","0","7","1","261"
"Sheridan",2000,"5","277","1","6","3","287"
"Sheridan",2000,"6","313","2","11","1","327"
"Sheridan",2000,"7","357","2","5","1","365"
"Sheridan",2000,"8","307","3","10","2","322"
"Sheridan",2000,"9","323","2","5","3","333"
"Sheridan",2000,"10","354","2","5","2","363"
"Sheridan",2000,"11","354","0","6","1","361"
"Sheridan",2000,"12","377","2","8","1","388"
"Sheridan",2000,"13","370","3","8","1","382"
"Sheridan",2000,"14","406","0","15","8","429"
"Sheridan",2000,"15","482","2","12","3","499"
"Sheridan",2000,"16","459","3","10","5","477"
"Sheridan",2000,"17","458","1","8","4","471"
"Sheridan",2000,"18 to 20","1063","10","26","3","1102"
"Sheridan",2000,"21 to 24","999","3","22","9","1033"
"Sheridan",2000,"25 & over","17715","29","205","90","18039"
"Sheridan",2000,"Total","25981","73","388","142","26584"
"Washakie",2001,"0","103","0","0","2","105"
"Washakie",2001,"1","80","0","1","1","82"
"Washakie",2001,"2","99","0","2","1","102"
"Washakie",2001,"3","99","1","0","0","100"
"Washakie",2001,"4","92","1","0","0","93"
"Washakie",2001,"5","83","1","2","1","87"
"Washakie",2001,"6","97","2","1","1","101"
"Washakie",2001,"7","83","0","1","2","86"
"Washakie",2001,"8","95","1","1","0","97"
"Washakie",2001,"9","126","2","1","1","130"
"Washakie",2001,"10","115","0","0","0","115"
"Washakie",2001,"11","145","0","1","0","146"
"Washakie",2001,"12","122","0","1","1","124"
"Washakie",2001,"13","117","1","1","4","123"
"Washakie",2001,"14","134","0","3","1","138"
"Washakie",2001,"15","149","0","1","1","151"
"Washakie",2001,"16","164","3","3","0","170"
"Washakie",2001,"17","164","1","1","1","167"
"Washakie",2001,"18 to 20","295","2","3","0","300"
"Washakie",2001,"21 to 24","231","0","0","0","231"
"Washakie",2001,"25 & over","5340","5","37","38","5420"
"Washakie",2001,"Total","7933","20","60","55","8068"
"Albany",2014,"0","390","14","5","18","427"
"Albany",2014,"1","324","16","7","20","367"
"Albany",2014,"2","371","13","12","22","418"
"Albany",2014,"3","345","19","5","18","387"
"Albany",2014,"4","357","19","6","11","393"
"Albany",2014,"5","354","24","9","11","398"
"Albany",2014,"6","324","19","7","12","362"
"Albany",2014,"7","342","8","11","12","373"
"Albany",2014,"8","324","9","6","9","348"
"Albany",2014,"9","304","7","5","8","324"
"Albany",2014,"10","271","9","6","6","292"
"Albany",2014,"11","266","6","2","8","282"
"Albany",2014,"12","270","11","8","12","301"
"Albany",2014,"13","299","9","1","14","323"
"Albany",2014,"14","259","3","7","8","277"
"Albany",2014,"15","250","5","6","9","270"
"Albany",2014,"16","285","9","2","13","309"
"Albany",2014,"17","303","23","5","17","348"
"Albany",2014,"18 to 20","3721","75","28","174","3998"
"Albany",2014,"21 to 24","6703","208","108","206","7225"
"Albany",2014,"25 & over","19033","399","246","746","20424"
"Albany",2014,"Total","35095","905","492","1354","37846"
"Teton",2001,"0","190","2","3","2","197"
"Teton",2001,"1","179","1","0","1","181"
"Teton",2001,"2","177","2","1","3","183"
"Teton",2001,"3","177","2","0","0","179"
"Teton",2001,"4","184","0","2","1","187"
"Teton",2001,"5","171","2","1","4","178"
"Teton",2001,"6","197","2","0","3","202"
"Teton",2001,"7","176","3","1","0","180"
"Teton",2001,"8","174","1","1","1","177"
"Teton",2001,"9","201","1","0","1","203"
"Teton",2001,"10","217","0","0","2","219"
"Teton",2001,"11","215","1","0","2","218"
"Teton",2001,"12","232","1","0","2","235"
"Teton",2001,"13","208","0","0","1","209"
"Teton",2001,"14","215","0","1","2","218"
"Teton",2001,"15","210","0","1","0","211"
"Teton",2001,"16","236","0","2","1","239"
"Teton",2001,"17","240","1","1","3","245"
"Teton",2001,"18 to 20","537","1","3","4","545"
"Teton",2001,"21 to 24","1151","4","7","11","1173"
"Teton",2001,"25 & over","13067","28","79","100","13274"
"Teton",2001,"Total","18354","52","103","144","18653"
"Weston",2004,"0","72","0","2","0","74"
"Weston",2004,"1","63","1","2","1","67"
"Weston",2004,"2","50","1","2","0","53"
"Weston",2004,"3","65","0","3","0","68"
"Weston",2004,"4","63","1","2","0","66"
"Weston",2004,"5","77","0","0","0","77"
"Weston",2004,"6","81","0","2","1","84"
"Weston",2004,"7","72","0","0","1","73"
"Weston",2004,"8","68","1","2","0","71"
"Weston",2004,"9","69","0","2","0","71"
"Weston",2004,"10","71","0","1","0","72"
"Weston",2004,"11","74","1","1","0","76"
"Weston",2004,"12","72","1","0","0","73"
"Weston",2004,"13","93","2","2","1","98"
"Weston",2004,"14","86","0","2","0","88"
"Weston",2004,"15","121","0","2","0","123"
"Weston",2004,"16","107","0","1","0","108"
"Weston",2004,"17","107","0","2","0","109"
"Weston",2004,"18 to 20","261","1","9","0","271"
"Weston",2004,"21 to 24","319","3","5","0","327"
"Weston",2004,"25 & over","4531","7","49","10","4597"
"Weston",2004,"Total","6522","19","91","14","6646"
"Sweetwater",1990,"0","591","5","7","2","605"
"Sweetwater",1990,"1","599","5","6","8","618"
"Sweetwater",1990,"2","617","6","9","2","634"
"Sweetwater",1990,"3","645","9","5","2","661"
"Sweetwater",1990,"4","668","4","7","2","681"
"Sweetwater",1990,"5","698","7","5","6","716"
"Sweetwater",1990,"6","735","9","7","2","753"
"Sweetwater",1990,"7","814","2","10","6","832"
"Sweetwater",1990,"8","745","1","4","5","755"
"Sweetwater",1990,"9","891","2","6","6","905"
"Sweetwater",1990,"10","869","7","10","1","887"
"Sweetwater",1990,"11","812","3","4","5","824"
"Sweetwater",1990,"12","797","3","6","2","808"
"Sweetwater",1990,"13","791","7","5","3","806"
"Sweetwater",1990,"14","690","7","7","4","708"
"Sweetwater",1990,"15","672","5","6","3","686"
"Sweetwater",1990,"16","676","8","9","7","700"
"Sweetwater",1990,"17","644","6","4","5","659"
"Sweetwater",1990,"18 to 20","1526","17","10","11","1564"
"Sweetwater",1990,"21 to 24","1516","20","12","5","1553"
"Sweetwater",1990,"25 & over","21965","152","168","152","22437"
"Sweetwater",1990,"Total","37961","285","307","239","38792"
"Crook",1997,"0","69","0","0","0","69"
"Crook",1997,"1","66","0","2","0","68"
"Crook",1997,"2","65","0","0","0","65"
"Crook",1997,"3","60","0","0","0","60"
"Crook",1997,"4","71","0","0","0","71"
"Crook",1997,"5","75","0","2","0","77"
"Crook",1997,"6","87","0","0","0","87"
"Crook",1997,"7","92","0","0","0","92"
"Crook",1997,"8","85","0","0","0","85"
"Crook",1997,"9","85","0","0","0","85"
"Crook",1997,"10","98","0","5","0","103"
"Crook",1997,"11","109","0","0","0","109"
"Crook",1997,"12","107","0","0","0","107"
"Crook",1997,"13","119","0","0","0","119"
"Crook",1997,"14","113","0","0","0","113"
"Crook",1997,"15","114","0","5","0","119"
"Crook",1997,"16","114","0","0","0","114"
"Crook",1997,"17","121","0","0","0","121"
"Crook",1997,"18 to 20","214","0","3","0","217"
"Crook",1997,"21 to 24","187","0","0","0","187"
"Crook",1997,"25 & over","3777","0","14","0","3791"
"Crook",1997,"Total","5828","0","31","0","5859"
"Laramie",1990,"0","1187","63","17","13","1280"
"Laramie",1990,"1","1080","57","7","20","1164"
"Laramie",1990,"2","1068","57","12","15","1152"
"Laramie",1990,"3","1107","60","9","15","1191"
"Laramie",1990,"4","1097","44","11","15","1167"
"Laramie",1990,"5","1136","51","10","17","1214"
"Laramie",1990,"6","1074","53","12","13","1152"
"Laramie",1990,"7","1113","40","9","15","1177"
"Laramie",1990,"8","1079","33","9","12","1133"
"Laramie",1990,"9","1116","57","11","10","1194"
"Laramie",1990,"10","1133","56","16","21","1226"
"Laramie",1990,"11","1047","35","10","17","1109"
"Laramie",1990,"12","1010","34","13","8","1065"
"Laramie",1990,"13","1014","39","8","11","1072"
"Laramie",1990,"14","936","33","15","22","1006"
"Laramie",1990,"15","1013","40","5","13","1071"
"Laramie",1990,"16","959","35","10","14","1018"
"Laramie",1990,"17","986","40","8","29","1063"
"Laramie",1990,"18 to 20","2953","126","35","48","3162"
"Laramie",1990,"21 to 24","3874","180","40","55","4149"
"Laramie",1990,"25 & over","43449","1159","304","498","45410"
"Laramie",1990,"Total","69431","2292","571","881","73175"
"Niobrara",2015,"0","26","0","0","0","26"
"Niobrara",2015,"1","18","0","0","0","18"
"Niobrara",2015,"2","31","1","0","0","32"
"Niobrara",2015,"3","24","0","1","0","25"
"Niobrara",2015,"4","20","0","1","0","21"
"Niobrara",2015,"5","26","0","0","0","26"
"Niobrara",2015,"6","20","0","1","0","21"
"Niobrara",2015,"7","19","0","0","0","19"
"Niobrara",2015,"8","24","0","0","0","24"
"Niobrara",2015,"9","21","0","2","0","23"
"Niobrara",2015,"10","21","0","0","0","21"
"Niobrara",2015,"11","18","0","0","0","18"
"Niobrara",2015,"12","37","1","0","1","39"
"Niobrara",2015,"13","26","0","0","1","27"
"Niobrara",2015,"14","33","0","0","1","34"
"Niobrara",2015,"15","17","1","0","0","18"
"Niobrara",2015,"16","41","0","0","1","42"
"Niobrara",2015,"17","28","2","0","0","30"
"Niobrara",2015,"18 to 20","69","3","0","1","73"
"Niobrara",2015,"21 to 24","106","3","1","2","112"
"Niobrara",2015,"25 & over","1796","16","28","8","1848"
"Niobrara",2015,"Total","2421","27","34","15","2497"
"Carbon",2001,"0","176","0","4","2","182"
"Carbon",2001,"1","171","1","5","0","177"
"Carbon",2001,"2","178","3","3","2","186"
"Carbon",2001,"3","170","3","4","2","179"
"Carbon",2001,"4","173","3","1","0","177"
"Carbon",2001,"5","170","0","4","1","175"
"Carbon",2001,"6","177","4","5","1","187"
"Carbon",2001,"7","165","0","3","1","169"
"Carbon",2001,"8","183","1","7","2","193"
"Carbon",2001,"9","180","1","8","2","191"
"Carbon",2001,"10","193","1","5","4","203"
"Carbon",2001,"11","189","2","2","1","194"
"Carbon",2001,"12","203","2","0","2","207"
"Carbon",2001,"13","197","1","3","0","201"
"Carbon",2001,"14","237","3","1","2","243"
"Carbon",2001,"15","233","2","2","3","240"
"Carbon",2001,"16","238","2","3","4","247"
"Carbon",2001,"17","251","2","9","4","266"
"Carbon",2001,"18 to 20","559","7","9","4","579"
"Carbon",2001,"21 to 24","703","8","14","5","730"
"Carbon",2001,"25 & over","10001","67","138","85","10291"
"Carbon",2001,"Total","14747","113","230","127","15217"
"Albany",2013,"0","372","13","4","23","412"
"Albany",2013,"1","391","14","16","21","442"
"Albany",2013,"2","358","12","4","15","389"
"Albany",2013,"3","353","17","4","5","379"
"Albany",2013,"4","363","16","8","11","398"
"Albany",2013,"5","342","21","9","9","381"
"Albany",2013,"6","338","11","7","13","369"
"Albany",2013,"7","330","6","5","8","349"
"Albany",2013,"8","298","8","6","7","319"
"Albany",2013,"9","281","12","7","7","307"
"Albany",2013,"10","254","5","3","6","268"
"Albany",2013,"11","272","9","8","13","302"
"Albany",2013,"12","287","5","4","13","309"
"Albany",2013,"13","242","4","7","8","261"
"Albany",2013,"14","247","5","4","7","263"
"Albany",2013,"15","273","6","4","12","295"
"Albany",2013,"16","295","11","5","15","326"
"Albany",2013,"17","292","20","6","13","331"
"Albany",2013,"18 to 20","3791","90","19","149","4049"
"Albany",2013,"21 to 24","6760","194","110","219","7283"
"Albany",2013,"25 & over","18722","486","233","763","20204"
"Albany",2013,"Total","34861","965","473","1337","37636"
"Johnson",1990,"0","77","0","1","0","78"
"Johnson",1990,"1","84","0","0","0","84"
"Johnson",1990,"2","75","0","0","0","75"
"Johnson",1990,"3","73","0","0","0","73"
"Johnson",1990,"4","82","0","0","0","82"
"Johnson",1990,"5","88","0","1","0","89"
"Johnson",1990,"6","88","0","2","0","90"
"Johnson",1990,"7","94","0","0","0","94"
"Johnson",1990,"8","93","0","5","0","98"
"Johnson",1990,"9","98","0","1","0","99"
"Johnson",1990,"10","110","0","1","0","111"
"Johnson",1990,"11","108","0","0","0","108"
"Johnson",1990,"12","91","0","0","0","91"
"Johnson",1990,"13","91","0","2","0","93"
"Johnson",1990,"14","92","0","4","0","96"
"Johnson",1990,"15","90","0","2","1","93"
"Johnson",1990,"16","113","0","0","0","113"
"Johnson",1990,"17","84","0","0","0","84"
"Johnson",1990,"18 to 20","210","0","0","0","210"
"Johnson",1990,"21 to 24","187","0","0","0","187"
"Johnson",1990,"25 & over","4111","0","13","0","4124"
"Johnson",1990,"Total","6139","0","32","1","6172"
"Converse",2011,"0","157","4","2","0","163"
"Converse",2011,"1","197","3","4","2","206"
"Converse",2011,"2","178","4","1","1","184"
"Converse",2011,"3","193","3","1","0","197"
"Converse",2011,"4","201","3","1","2","207"
"Converse",2011,"5","185","6","4","0","195"
"Converse",2011,"6","197","2","5","1","205"
"Converse",2011,"7","179","2","3","0","184"
"Converse",2011,"8","174","3","2","1","180"
"Converse",2011,"9","183","3","4","1","191"
"Converse",2011,"10","187","2","0","1","190"
"Converse",2011,"11","190","4","1","1","196"
"Converse",2011,"12","192","5","2","1","200"
"Converse",2011,"13","171","5","3","0","179"
"Converse",2011,"14","173","2","4","1","180"
"Converse",2011,"15","183","6","1","0","190"
"Converse",2011,"16","174","5","0","0","179"
"Converse",2011,"17","204","0","1","0","205"
"Converse",2011,"18 to 20","466","4","4","2","476"
"Converse",2011,"21 to 24","581","9","4","1","595"
"Converse",2011,"25 & over","9046","44","97","41","9228"
"Converse",2011,"Total","13411","119","144","56","13730"
"Crook",1992,"0","83","0","0","0","83"
"Crook",1992,"1","73","0","1","0","74"
"Crook",1992,"2","81","0","0","0","81"
"Crook",1992,"3","73","0","0","0","73"
"Crook",1992,"4","84","0","0","0","84"
"Crook",1992,"5","76","0","1","0","77"
"Crook",1992,"6","96","0","0","0","96"
"Crook",1992,"7","101","0","0","0","101"
"Crook",1992,"8","98","0","0","0","98"
"Crook",1992,"9","106","0","0","0","106"
"Crook",1992,"10","108","0","2","0","110"
"Crook",1992,"11","109","0","0","0","109"
"Crook",1992,"12","114","0","0","0","114"
"Crook",1992,"13","108","0","0","0","108"
"Crook",1992,"14","97","0","0","0","97"
"Crook",1992,"15","98","0","1","0","99"
"Crook",1992,"16","90","0","0","0","90"
"Crook",1992,"17","85","0","0","0","85"
"Crook",1992,"18 to 20","166","0","2","0","168"
"Crook",1992,"21 to 24","170","0","0","0","170"
"Crook",1992,"25 & over","3366","0","16","0","3382"
"Crook",1992,"Total","5382","0","23","0","5405"
"Natrona",2000,"0","784","17","11","5","817"
"Natrona",2000,"1","856","16","10","7","889"
"Natrona",2000,"2","790","19","15","4","828"
"Natrona",2000,"3","843","22","15","7","887"
"Natrona",2000,"4","844","17","11","5","877"
"Natrona",2000,"5","862","18","13","1","894"
"Natrona",2000,"6","888","13","15","4","920"
"Natrona",2000,"7","861","14","10","6","891"
"Natrona",2000,"8","921","12","18","1","952"
"Natrona",2000,"9","906","13","20","7","946"
"Natrona",2000,"10","1035","22","16","3","1076"
"Natrona",2000,"11","943","16","14","4","977"
"Natrona",2000,"12","955","16","18","7","996"
"Natrona",2000,"13","992","12","17","6","1027"
"Natrona",2000,"14","984","11","22","5","1022"
"Natrona",2000,"15","1098","13","16","10","1137"
"Natrona",2000,"16","1001","8","11","3","1023"
"Natrona",2000,"17","1077","11","10","6","1104"
"Natrona",2000,"18 to 20","3226","48","46","20","3340"
"Natrona",2000,"21 to 24","3291","39","46","26","3402"
"Natrona",2000,"25 & over","41660","300","433","205","42598"
"Natrona",2000,"Total","64817","657","787","342","66603"
"Carbon",1996,"0","176","0","0","2","178"
"Carbon",1996,"1","188","0","8","0","196"
"Carbon",1996,"2","184","5","0","0","189"
"Carbon",1996,"3","179","0","3","0","182"
"Carbon",1996,"4","192","0","0","0","192"
"Carbon",1996,"5","204","4","9","0","217"
"Carbon",1996,"6","212","0","2","0","214"
"Carbon",1996,"7","211","0","0","1","212"
"Carbon",1996,"8","203","2","7","1","213"
"Carbon",1996,"9","212","0","0","3","215"
"Carbon",1996,"10","235","3","7","4","249"
"Carbon",1996,"11","245","3","4","0","252"
"Carbon",1996,"12","261","5","0","3","269"
"Carbon",1996,"13","274","0","0","0","274"
"Carbon",1996,"14","286","0","0","3","289"
"Carbon",1996,"15","283","1","0","5","289"
"Carbon",1996,"16","288","0","0","3","291"
"Carbon",1996,"17","291","0","1","2","294"
"Carbon",1996,"18 to 20","571","8","13","3","595"
"Carbon",1996,"21 to 24","730","6","14","4","754"
"Carbon",1996,"25 & over","10314","59","106","48","10527"
"Carbon",1996,"Total","15739","96","174","82","16091"
"Johnson",2015,"0","70","1","1","0","72"
"Johnson",2015,"1","97","1","3","1","102"
"Johnson",2015,"2","93","2","2","1","98"
"Johnson",2015,"3","92","4","3","3","102"
"Johnson",2015,"4","110","7","9","2","128"
"Johnson",2015,"5","93","1","9","6","109"
"Johnson",2015,"6","101","3","5","2","111"
"Johnson",2015,"7","108","4","5","4","121"
"Johnson",2015,"8","115","1","3","1","120"
"Johnson",2015,"9","118","1","5","0","124"
"Johnson",2015,"10","118","2","2","1","123"
"Johnson",2015,"11","106","1","2","0","109"
"Johnson",2015,"12","86","2","3","0","91"
"Johnson",2015,"13","104","1","2","0","107"
"Johnson",2015,"14","96","1","1","0","98"
"Johnson",2015,"15","92","3","2","0","97"
"Johnson",2015,"16","89","0","2","0","91"
"Johnson",2015,"17","103","0","1","0","104"
"Johnson",2015,"18 to 20","247","4","4","2","257"
"Johnson",2015,"21 to 24","268","6","6","6","286"
"Johnson",2015,"25 & over","5957","69","59","52","6137"
"Johnson",2015,"Total","8263","114","129","81","8587"
"Sweetwater",1994,"0","543","6","6","2","557"
"Sweetwater",1994,"1","574","6","7","6","593"
"Sweetwater",1994,"2","568","5","11","1","585"
"Sweetwater",1994,"3","579","8","8","1","596"
"Sweetwater",1994,"4","602","7","6","1","616"
"Sweetwater",1994,"5","584","9","6","5","604"
"Sweetwater",1994,"6","642","11","10","3","666"
"Sweetwater",1994,"7","682","5","9","3","699"
"Sweetwater",1994,"8","695","2","4","3","704"
"Sweetwater",1994,"9","794","2","10","5","811"
"Sweetwater",1994,"10","754","6","13","2","775"
"Sweetwater",1994,"11","804","5","9","3","821"
"Sweetwater",1994,"12","834","5","7","2","848"
"Sweetwater",1994,"13","860","8","10","3","881"
"Sweetwater",1994,"14","811","10","9","3","833"
"Sweetwater",1994,"15","747","8","8","1","764"
"Sweetwater",1994,"16","765","7","10","5","787"
"Sweetwater",1994,"17","764","5","7","5","781"
"Sweetwater",1994,"18 to 20","1774","17","12","16","1819"
"Sweetwater",1994,"21 to 24","1779","14","21","13","1827"
"Sweetwater",1994,"25 & over","22886","165","191","151","23393"
"Sweetwater",1994,"Total","39041","311","374","234","39960"
"Laramie",2009,"0","1174","64","27","15","1280"
"Laramie",2009,"1","1217","93","30","16","1356"
"Laramie",2009,"2","1247","71","24","22","1364"
"Laramie",2009,"3","1239","69","19","22","1349"
"Laramie",2009,"4","1145","59","32","48","1284"
"Laramie",2009,"5","1143","66","19","14","1242"
"Laramie",2009,"6","1188","41","23","40","1292"
"Laramie",2009,"7","1089","45","22","29","1185"
"Laramie",2009,"8","1105","53","33","16","1207"
"Laramie",2009,"9","1101","65","12","17","1195"
"Laramie",2009,"10","1129","32","20","23","1204"
"Laramie",2009,"11","1127","85","36","16","1264"
"Laramie",2009,"12","1005","54","34","11","1104"
"Laramie",2009,"13","1094","39","9","13","1155"
"Laramie",2009,"14","1017","61","16","30","1124"
"Laramie",2009,"15","1078","57","24","13","1172"
"Laramie",2009,"16","1161","56","23","31","1271"
"Laramie",2009,"17","1086","42","18","16","1162"
"Laramie",2009,"18 to 20","3348","208","51","69","3676"
"Laramie",2009,"21 to 24","4627","325","90","104","5146"
"Laramie",2009,"25 & over","56316","1483","701","898","59398"
"Laramie",2009,"Total","84636","3068","1263","1463","90430"
"Laramie",2000,"0","1009","60","11","16","1096"
"Laramie",2000,"1","995","57","18","20","1090"
"Laramie",2000,"2","997","51","20","15","1083"
"Laramie",2000,"3","1003","41","12","12","1068"
"Laramie",2000,"4","962","46","15","22","1045"
"Laramie",2000,"5","1056","51","14","18","1139"
"Laramie",2000,"6","1079","37","17","13","1146"
"Laramie",2000,"7","1156","44","15","23","1238"
"Laramie",2000,"8","1098","58","11","24","1191"
"Laramie",2000,"9","1119","47","14","16","1196"
"Laramie",2000,"10","1153","47","17","14","1231"
"Laramie",2000,"11","1118","58","17","13","1206"
"Laramie",2000,"12","1112","41","16","18","1187"
"Laramie",2000,"13","1163","38","12","16","1229"
"Laramie",2000,"14","1167","44","21","11","1243"
"Laramie",2000,"15","1196","49","9","20","1274"
"Laramie",2000,"16","1178","32","17","14","1241"
"Laramie",2000,"17","1099","40","11","16","1166"
"Laramie",2000,"18 to 20","3103","193","52","51","3399"
"Laramie",2000,"21 to 24","4041","222","64","79","4406"
"Laramie",2000,"25 & over","50533","1284","488","646","52951"
"Laramie",2000,"Total","77337","2540","871","1077","81825"
"Albany",1996,"0","351","6","3","10","370"
"Albany",1996,"1","325","21","4","17","367"
"Albany",1996,"2","339","4","4","10","357"
"Albany",1996,"3","329","0","3","5","337"
"Albany",1996,"4","325","8","5","11","349"
"Albany",1996,"5","338","1","2","4","345"
"Albany",1996,"6","318","8","9","2","337"
"Albany",1996,"7","338","5","5","7","355"
"Albany",1996,"8","316","9","3","3","331"
"Albany",1996,"9","340","7","8","8","363"
"Albany",1996,"10","349","2","7","3","361"
"Albany",1996,"11","342","6","4","6","358"
"Albany",1996,"12","347","8","4","11","370"
"Albany",1996,"13","374","7","8","9","398"
"Albany",1996,"14","365","0","7","4","376"
"Albany",1996,"15","371","3","7","4","385"
"Albany",1996,"16","385","0","7","2","394"
"Albany",1996,"17","381","5","1","4","391"
"Albany",1996,"18 to 20","4016","60","33","43","4152"
"Albany",1996,"21 to 24","4701","73","37","106","4917"
"Albany",1996,"25 & over","16652","113","137","364","17266"
"Albany",1996,"Total","31602","346","298","633","32879"
"Uinta",2013,"0","299","7","5","5","316"
"Uinta",2013,"1","333","8","5","2","348"
"Uinta",2013,"2","298","14","11","2","325"
"Uinta",2013,"3","332","6","6","3","347"
"Uinta",2013,"4","329","5","6","5","345"
"Uinta",2013,"5","354","5","5","2","366"
"Uinta",2013,"6","348","3","4","1","356"
"Uinta",2013,"7","359","4","3","4","370"
"Uinta",2013,"8","324","2","7","4","337"
"Uinta",2013,"9","368","3","8","3","382"
"Uinta",2013,"10","324","3","4","2","333"
"Uinta",2013,"11","355","3","4","5","367"
"Uinta",2013,"12","324","5","3","3","335"
"Uinta",2013,"13","344","2","3","1","350"
"Uinta",2013,"14","316","3","6","2","327"
"Uinta",2013,"15","339","4","6","2","351"
"Uinta",2013,"16","327","2","2","2","333"
"Uinta",2013,"17","297","4","3","3","307"
"Uinta",2013,"18 to 20","734","21","14","4","773"
"Uinta",2013,"21 to 24","851","18","26","5","900"
"Uinta",2013,"25 & over","12788","116","161","73","13138"
"Uinta",2013,"Total","20343","238","292","133","21006"
"Sublette",1992,"0","63","0","0","0","63"
"Sublette",1992,"1","70","0","3","2","75"
"Sublette",1992,"2","73","0","0","0","73"
"Sublette",1992,"3","70","0","0","0","70"
"Sublette",1992,"4","71","0","0","0","71"
"Sublette",1992,"5","64","0","3","0","67"
"Sublette",1992,"6","67","0","0","0","67"
"Sublette",1992,"7","84","0","0","0","84"
"Sublette",1992,"8","73","0","3","0","76"
"Sublette",1992,"9","81","0","0","0","81"
"Sublette",1992,"10","77","0","7","0","84"
"Sublette",1992,"11","99","0","0","0","99"
"Sublette",1992,"12","85","0","0","0","85"
"Sublette",1992,"13","90","0","0","0","90"
"Sublette",1992,"14","76","0","0","0","76"
"Sublette",1992,"15","82","0","0","0","82"
"Sublette",1992,"16","79","0","0","0","79"
"Sublette",1992,"17","75","0","0","0","75"
"Sublette",1992,"18 to 20","143","0","0","0","143"
"Sublette",1992,"21 to 24","165","0","3","0","168"
"Sublette",1992,"25 & over","3287","2","23","2","3314"
"Sublette",1992,"Total","4974","2","42","4","5022"
"Goshen",2013,"0","134","2","11","1","148"
"Goshen",2013,"1","132","2","3","1","138"
"Goshen",2013,"2","114","3","0","0","117"
"Goshen",2013,"3","147","1","2","1","151"
"Goshen",2013,"4","156","2","4","2","164"
"Goshen",2013,"5","129","5","0","3","137"
"Goshen",2013,"6","156","4","4","0","164"
"Goshen",2013,"7","125","3","1","1","130"
"Goshen",2013,"8","123","1","1","0","125"
"Goshen",2013,"9","146","1","0","3","150"
"Goshen",2013,"10","129","1","4","3","137"
"Goshen",2013,"11","140","0","1","2","143"
"Goshen",2013,"12","159","1","2","1","163"
"Goshen",2013,"13","162","2","2","1","167"
"Goshen",2013,"14","160","1","0","1","162"
"Goshen",2013,"15","168","4","4","1","177"
"Goshen",2013,"16","169","1","3","2","175"
"Goshen",2013,"17","145","2","1","1","149"
"Goshen",2013,"18 to 20","579","17","12","4","612"
"Goshen",2013,"21 to 24","785","15","13","5","818"
"Goshen",2013,"25 & over","9191","102","78","49","9420"
"Goshen",2013,"Total","13149","170","146","82","13547"
"Park",2004,"0","238","2","3","1","244"
"Park",2004,"1","275","1","1","1","278"
"Park",2004,"2","262","2","5","2","271"
"Park",2004,"3","239","2","1","1","243"
"Park",2004,"4","260","0","2","2","264"
"Park",2004,"5","257","0","1","1","259"
"Park",2004,"6","301","3","1","1","306"
"Park",2004,"7","276","2","1","1","280"
"Park",2004,"8","327","3","3","1","334"
"Park",2004,"9","279","1","1","1","282"
"Park",2004,"10","301","2","4","2","309"
"Park",2004,"11","331","1","3","2","337"
"Park",2004,"12","342","3","6","3","354"
"Park",2004,"13","365","6","3","2","376"
"Park",2004,"14","354","2","2","3","361"
"Park",2004,"15","403","2","1","2","408"
"Park",2004,"16","391","0","2","3","396"
"Park",2004,"17","392","1","2","2","397"
"Park",2004,"18 to 20","1237","4","15","18","1274"
"Park",2004,"21 to 24","1239","5","9","9","1262"
"Park",2004,"25 & over","17642","20","91","90","17843"
"Park",2004,"Total","25711","62","157","148","26078"
"Lincoln",2008,"0","290","0","0","1","291"
"Lincoln",2008,"1","302","2","2","0","306"
"Lincoln",2008,"2","286","1","3","0","290"
"Lincoln",2008,"3","256","0","2","0","258"
"Lincoln",2008,"4","245","1","2","1","249"
"Lincoln",2008,"5","291","1","3","1","296"
"Lincoln",2008,"6","272","1","4","0","277"
"Lincoln",2008,"7","259","0","6","0","265"
"Lincoln",2008,"8","267","4","3","0","274"
"Lincoln",2008,"9","274","1","3","0","278"
"Lincoln",2008,"10","265","1","5","1","272"
"Lincoln",2008,"11","286","3","6","1","296"
"Lincoln",2008,"12","261","1","2","1","265"
"Lincoln",2008,"13","250","3","4","1","258"
"Lincoln",2008,"14","288","2","2","0","292"
"Lincoln",2008,"15","272","2","4","1","279"
"Lincoln",2008,"16","257","3","3","1","264"
"Lincoln",2008,"17","314","0","6","0","320"
"Lincoln",2008,"18 to 20","499","2","3","1","505"
"Lincoln",2008,"21 to 24","660","3","9","2","674"
"Lincoln",2008,"25 & over","11267","19","94","40","11420"
"Lincoln",2008,"Total","17361","50","166","52","17629"
"Albany",2012,"0","410","10","7","25","452"
"Albany",2012,"1","379","15","2","15","411"
"Albany",2012,"2","349","15","5","7","376"
"Albany",2012,"3","376","18","4","10","408"
"Albany",2012,"4","362","18","6","10","396"
"Albany",2012,"5","360","9","7","12","388"
"Albany",2012,"6","332","10","3","7","352"
"Albany",2012,"7","322","6","8","10","346"
"Albany",2012,"8","312","12","6","6","336"
"Albany",2012,"9","255","5","3","6","269"
"Albany",2012,"10","275","12","7","11","305"
"Albany",2012,"11","299","8","4","11","322"
"Albany",2012,"12","254","5","6","5","270"
"Albany",2012,"13","251","7","3","6","267"
"Albany",2012,"14","276","11","2","11","300"
"Albany",2012,"15","300","6","4","14","324"
"Albany",2012,"16","282","6","4","10","302"
"Albany",2012,"17","307","19","4","7","337"
"Albany",2012,"18 to 20","3842","89","27","126","4084"
"Albany",2012,"21 to 24","6556","166","105","274","7101"
"Albany",2012,"25 & over","18772","338","222","686","20018"
"Albany",2012,"Total","34871","785","439","1269","37364"
"Sublette",2012,"0","138","1","0","0","139"
"Sublette",2012,"1","152","2","0","0","154"
"Sublette",2012,"2","124","1","0","0","125"
"Sublette",2012,"3","143","6","1","1","151"
"Sublette",2012,"4","151","2","3","0","156"
"Sublette",2012,"5","135","3","3","0","141"
"Sublette",2012,"6","133","2","1","1","137"
"Sublette",2012,"7","130","2","2","1","135"
"Sublette",2012,"8","132","2","2","4","140"
"Sublette",2012,"9","137","2","1","2","142"
"Sublette",2012,"10","127","1","2","14","144"
"Sublette",2012,"11","120","0","1","15","136"
"Sublette",2012,"12","132","3","2","4","141"
"Sublette",2012,"13","128","1","2","1","132"
"Sublette",2012,"14","139","2","2","1","144"
"Sublette",2012,"15","123","1","2","1","127"
"Sublette",2012,"16","122","2","2","0","126"
"Sublette",2012,"17","138","2","4","2","146"
"Sublette",2012,"18 to 20","303","12","9","2","326"
"Sublette",2012,"21 to 24","410","6","4","10","430"
"Sublette",2012,"25 & over","6927","93","65","57","7142"
"Sublette",2012,"Total","10044","146","108","116","10414"
"Lincoln",2004,"0","208","0","2","1","211"
"Lincoln",2004,"1","215","0","1","2","218"
"Lincoln",2004,"2","220","1","4","1","226"
"Lincoln",2004,"3","188","0","1","2","191"
"Lincoln",2004,"4","233","1","3","1","238"
"Lincoln",2004,"5","220","1","3","1","225"
"Lincoln",2004,"6","230","0","2","0","232"
"Lincoln",2004,"7","223","0","1","0","224"
"Lincoln",2004,"8","219","2","2","0","223"
"Lincoln",2004,"9","215","2","1","0","218"
"Lincoln",2004,"10","271","2","3","0","276"
"Lincoln",2004,"11","268","3","6","0","277"
"Lincoln",2004,"12","250","3","1","2","256"
"Lincoln",2004,"13","282","1","2","0","285"
"Lincoln",2004,"14","244","1","1","1","247"
"Lincoln",2004,"15","288","2","2","1","293"
"Lincoln",2004,"16","287","1","1","3","292"
"Lincoln",2004,"17","300","2","2","0","304"
"Lincoln",2004,"18 to 20","557","2","4","3","566"
"Lincoln",2004,"21 to 24","634","2","5","0","641"
"Lincoln",2004,"25 & over","9780","12","67","37","9896"
"Lincoln",2004,"Total","15332","38","114","55","15539"
"Goshen",2003,"0","155","1","3","1","160"
"Goshen",2003,"1","129","2","2","2","135"
"Goshen",2003,"2","144","2","1","1","148"
"Goshen",2003,"3","166","0","1","0","167"
"Goshen",2003,"4","130","0","0","1","131"
"Goshen",2003,"5","135","0","2","0","137"
"Goshen",2003,"6","115","1","4","1","121"
"Goshen",2003,"7","125","0","2","0","127"
"Goshen",2003,"8","125","1","2","1","129"
"Goshen",2003,"9","172","0","2","0","174"
"Goshen",2003,"10","125","4","0","0","129"
"Goshen",2003,"11","161","1","3","0","165"
"Goshen",2003,"12","186","1","4","4","195"
"Goshen",2003,"13","188","2","3","0","193"
"Goshen",2003,"14","157","1","3","3","164"
"Goshen",2003,"15","170","2","2","0","174"
"Goshen",2003,"16","188","1","2","1","192"
"Goshen",2003,"17","176","1","5","2","184"
"Goshen",2003,"18 to 20","605","6","7","6","624"
"Goshen",2003,"21 to 24","595","2","4","3","604"
"Goshen",2003,"25 & over","8217","22","61","21","8321"
"Goshen",2003,"Total","12164","50","113","47","12374"
"Converse",1995,"0","156","0","0","0","156"
"Converse",1995,"1","141","2","3","0","146"
"Converse",1995,"2","146","2","0","0","148"
"Converse",1995,"3","164","0","0","0","164"
"Converse",1995,"4","175","0","4","0","179"
"Converse",1995,"5","193","2","2","1","198"
"Converse",1995,"6","164","0","0","0","164"
"Converse",1995,"7","184","2","3","0","189"
"Converse",1995,"8","193","0","0","0","193"
"Converse",1995,"9","220","0","5","1","226"
"Converse",1995,"10","212","0","0","2","214"
"Converse",1995,"11","211","0","2","0","213"
"Converse",1995,"12","229","0","6","0","235"
"Converse",1995,"13","240","0","0","0","240"
"Converse",1995,"14","252","3","4","2","261"
"Converse",1995,"15","235","1","0","1","237"
"Converse",1995,"16","212","0","4","0","216"
"Converse",1995,"17","251","0","3","0","254"
"Converse",1995,"18 to 20","383","0","7","0","390"
"Converse",1995,"21 to 24","428","0","3","0","431"
"Converse",1995,"25 & over","7189","3","55","12","7259"
"Converse",1995,"Total","11578","15","101","19","11713"
"Big Horn",1993,"0","143","0","0","0","143"
"Big Horn",1993,"1","142","0","2","0","144"
"Big Horn",1993,"2","162","0","0","0","162"
"Big Horn",1993,"3","157","0","0","0","157"
"Big Horn",1993,"4","151","0","3","0","154"
"Big Horn",1993,"5","147","0","5","2","154"
"Big Horn",1993,"6","165","0","0","0","165"
"Big Horn",1993,"7","177","0","0","0","177"
"Big Horn",1993,"8","181","0","0","0","181"
"Big Horn",1993,"9","204","0","0","0","204"
"Big Horn",1993,"10","196","0","3","1","200"
"Big Horn",1993,"11","190","0","1","0","191"
"Big Horn",1993,"12","214","0","2","0","216"
"Big Horn",1993,"13","205","0","0","0","205"
"Big Horn",1993,"14","203","0","0","1","204"
"Big Horn",1993,"15","186","0","3","0","189"
"Big Horn",1993,"16","202","0","0","0","202"
"Big Horn",1993,"17","195","0","3","2","200"
"Big Horn",1993,"18 to 20","346","0","6","0","352"
"Big Horn",1993,"21 to 24","374","0","0","0","374"
"Big Horn",1993,"25 & over","6756","0","31","9","6796"
"Big Horn",1993,"Total","10696","0","59","15","10770"
"Weston",2011,"0","80","0","0","0","80"
"Weston",2011,"1","93","2","2","1","98"
"Weston",2011,"2","83","2","2","0","87"
"Weston",2011,"3","73","3","0","0","76"
"Weston",2011,"4","69","1","3","0","73"
"Weston",2011,"5","89","1","4","0","94"
"Weston",2011,"6","104","1","1","0","106"
"Weston",2011,"7","93","0","4","0","97"
"Weston",2011,"8","83","2","4","1","90"
"Weston",2011,"9","77","0","3","1","81"
"Weston",2011,"10","88","0","1","0","89"
"Weston",2011,"11","73","2","0","1","76"
"Weston",2011,"12","76","1","3","0","80"
"Weston",2011,"13","82","1","2","0","85"
"Weston",2011,"14","94","2","4","0","100"
"Weston",2011,"15","74","0","2","0","76"
"Weston",2011,"16","87","0","1","0","88"
"Weston",2011,"17","93","1","3","0","97"
"Weston",2011,"18 to 20","198","2","4","1","205"
"Weston",2011,"21 to 24","296","4","3","1","304"
"Weston",2011,"25 & over","4911","32","69","18","5030"
"Weston",2011,"Total","6916","57","115","24","7112"
"Sweetwater",2005,"0","577","11","21","4","613"
"Sweetwater",2005,"1","562","12","12","3","589"
"Sweetwater",2005,"2","610","13","10","5","638"
"Sweetwater",2005,"3","542","20","10","4","576"
"Sweetwater",2005,"4","538","15","20","6","579"
"Sweetwater",2005,"5","536","11","8","3","558"
"Sweetwater",2005,"6","547","2","6","4","559"
"Sweetwater",2005,"7","510","10","12","6","538"
"Sweetwater",2005,"8","524","10","4","4","542"
"Sweetwater",2005,"9","491","9","7","7","514"
"Sweetwater",2005,"10","480","7","12","2","501"
"Sweetwater",2005,"11","535","10","15","3","563"
"Sweetwater",2005,"12","525","12","6","6","549"
"Sweetwater",2005,"13","593","9","12","4","618"
"Sweetwater",2005,"14","592","7","8","8","615"
"Sweetwater",2005,"15","584","4","6","4","598"
"Sweetwater",2005,"16","560","9","9","6","584"
"Sweetwater",2005,"17","558","8","12","7","585"
"Sweetwater",2005,"18 to 20","1792","29","24","22","1867"
"Sweetwater",2005,"21 to 24","2365","37","31","38","2471"
"Sweetwater",2005,"25 & over","23342","238","272","230","24082"
"Sweetwater",2005,"Total","37363","483","517","376","38739"
"Crook",2016,"0","94","2","1","0","97"
"Crook",2016,"1","104","2","1","0","107"
"Crook",2016,"2","105","0","0","0","105"
"Crook",2016,"3","90","1","0","0","91"
"Crook",2016,"4","112","2","0","1","115"
"Crook",2016,"5","100","2","0","0","102"
"Crook",2016,"6","110","0","0","0","110"
"Crook",2016,"7","83","0","1","0","84"
"Crook",2016,"8","105","2","1","1","109"
"Crook",2016,"9","105","0","3","1","109"
"Crook",2016,"10","99","2","3","1","105"
"Crook",2016,"11","100","1","2","0","103"
"Crook",2016,"12","93","1","1","0","95"
"Crook",2016,"13","95","1","1","0","97"
"Crook",2016,"14","97","2","3","1","103"
"Crook",2016,"15","92","1","3","0","96"
"Crook",2016,"16","101","1","1","0","103"
"Crook",2016,"17","82","0","2","0","84"
"Crook",2016,"18 to 20","191","3","1","0","195"
"Crook",2016,"21 to 24","260","5","3","0","268"
"Crook",2016,"25 & over","5066","58","44","18","5186"
"Crook",2016,"Total","7284","86","71","23","7464"
"Albany",2004,"0","358","8","5","8","379"
"Albany",2004,"1","359","16","3","9","387"
"Albany",2004,"2","306","11","3","16","336"
"Albany",2004,"3","337","7","5","7","356"
"Albany",2004,"4","273","9","3","9","294"
"Albany",2004,"5","263","7","2","7","279"
"Albany",2004,"6","276","10","5","7","298"
"Albany",2004,"7","283","7","6","17","313"
"Albany",2004,"8","271","11","5","7","294"
"Albany",2004,"9","287","7","3","5","302"
"Albany",2004,"10","247","8","8","3","266"
"Albany",2004,"11","294","9","4","8","315"
"Albany",2004,"12","280","9","6","6","301"
"Albany",2004,"13","288","7","4","8","307"
"Albany",2004,"14","302","5","6","4","317"
"Albany",2004,"15","297","8","4","3","312"
"Albany",2004,"16","286","2","7","5","300"
"Albany",2004,"17","316","8","3","5","332"
"Albany",2004,"18 to 20","4306","60","39","81","4486"
"Albany",2004,"21 to 24","6041","105","64","164","6374"
"Albany",2004,"25 & over","16250","176","200","406","17032"
"Albany",2004,"Total","31920","490","385","785","33580"
"Carbon",2000,"0","167","0","3","3","173"
"Carbon",2000,"1","180","1","5","0","186"
"Carbon",2000,"2","165","3","3","1","172"
"Carbon",2000,"3","172","3","4","2","181"
"Carbon",2000,"4","172","3","1","1","177"
"Carbon",2000,"5","179","0","3","1","183"
"Carbon",2000,"6","175","4","5","1","185"
"Carbon",2000,"7","181","0","3","1","185"
"Carbon",2000,"8","191","1","7","1","200"
"Carbon",2000,"9","189","0","3","2","194"
"Carbon",2000,"10","201","2","5","3","211"
"Carbon",2000,"11","193","2","2","1","198"
"Carbon",2000,"12","206","2","0","3","211"
"Carbon",2000,"13","229","1","3","0","233"
"Carbon",2000,"14","241","4","1","2","248"
"Carbon",2000,"15","250","2","2","5","259"
"Carbon",2000,"16","259","2","4","5","270"
"Carbon",2000,"17","271","2","6","4","283"
"Carbon",2000,"18 to 20","562","8","10","4","584"
"Carbon",2000,"21 to 24","718","10","15","6","749"
"Carbon",2000,"25 & over","10199","75","142","84","10500"
"Carbon",2000,"Total","15100","125","227","130","15582"
"Sheridan",2015,"0","304","4","7","5","320"
"Sheridan",2015,"1","337","6","16","11","370"
"Sheridan",2015,"2","302","5","6","8","321"
"Sheridan",2015,"3","312","2","8","3","325"
"Sheridan",2015,"4","335","5","7","11","358"
"Sheridan",2015,"5","358","5","9","2","374"
"Sheridan",2015,"6","339","2","8","0","349"
"Sheridan",2015,"7","369","4","12","4","389"
"Sheridan",2015,"8","385","4","10","2","401"
"Sheridan",2015,"9","362","4","9","1","376"
"Sheridan",2015,"10","341","10","8","3","362"
"Sheridan",2015,"11","340","9","6","1","356"
"Sheridan",2015,"12","344","12","7","3","366"
"Sheridan",2015,"13","323","6","4","1","334"
"Sheridan",2015,"14","331","5","13","2","351"
"Sheridan",2015,"15","383","7","12","1","403"
"Sheridan",2015,"16","347","6","10","4","367"
"Sheridan",2015,"17","351","4","9","1","365"
"Sheridan",2015,"18 to 20","1032","23","34","16","1105"
"Sheridan",2015,"21 to 24","1306","29","30","11","1376"
"Sheridan",2015,"25 & over","20441","189","283","188","21101"
"Sheridan",2015,"Total","28942","341","508","278","30069"
"Natrona",2012,"0","985","31","26","14","1056"
"Natrona",2012,"1","960","39","34","13","1046"
"Natrona",2012,"2","1018","30","20","8","1076"
"Natrona",2012,"3","1008","29","17","14","1068"
"Natrona",2012,"4","1074","31","20","13","1138"
"Natrona",2012,"5","1085","34","25","16","1160"
"Natrona",2012,"6","1066","32","24","7","1129"
"Natrona",2012,"7","999","23","18","11","1051"
"Natrona",2012,"8","993","22","23","14","1052"
"Natrona",2012,"9","975","24","18","12","1029"
"Natrona",2012,"10","935","13","17","6","971"
"Natrona",2012,"11","941","30","24","11","1006"
"Natrona",2012,"12","926","14","18","10","968"
"Natrona",2012,"13","916","30","18","17","981"
"Natrona",2012,"14","893","26","19","9","947"
"Natrona",2012,"15","873","24","23","9","929"
"Natrona",2012,"16","934","23","18","10","985"
"Natrona",2012,"17","938","22","18","13","991"
"Natrona",2012,"18 to 20","2695","94","59","32","2880"
"Natrona",2012,"21 to 24","4312","109","92","47","4560"
"Natrona",2012,"25 & over","50505","882","663","529","52579"
"Natrona",2012,"Total","75031","1562","1194","815","78602"
"Albany",1990,"0","386","5","3","12","406"
"Albany",1990,"1","356","11","6","20","393"
"Albany",1990,"2","368","2","5","10","385"
"Albany",1990,"3","375","0","5","5","385"
"Albany",1990,"4","377","7","3","10","397"
"Albany",1990,"5","380","3","3","9","395"
"Albany",1990,"6","372","4","6","4","386"
"Albany",1990,"7","371","4","5","8","388"
"Albany",1990,"8","372","7","4","1","384"
"Albany",1990,"9","379","4","9","7","399"
"Albany",1990,"10","395","3","5","1","404"
"Albany",1990,"11","345","2","3","7","357"
"Albany",1990,"12","332","5","3","8","348"
"Albany",1990,"13","320","3","6","5","334"
"Albany",1990,"14","292","0","5","4","301"
"Albany",1990,"15","304","2","8","5","319"
"Albany",1990,"16","321","0","4","2","327"
"Albany",1990,"17","314","6","2","8","330"
"Albany",1990,"18 to 20","3920","57","19","56","4052"
"Albany",1990,"21 to 24","3835","31","26","100","3992"
"Albany",1990,"25 & over","15633","101","108","355","16197"
"Albany",1990,"Total","29747","257","238","637","30879"
"Sublette",2007,"0","132","0","0","0","132"
"Sublette",2007,"1","113","5","2","1","121"
"Sublette",2007,"2","99","0","2","1","102"
"Sublette",2007,"3","108","1","1","0","110"
"Sublette",2007,"4","107","0","1","1","109"
"Sublette",2007,"5","117","0","1","0","118"
"Sublette",2007,"6","101","0","1","1","103"
"Sublette",2007,"7","104","1","1","0","106"
"Sublette",2007,"8","116","0","1","1","118"
"Sublette",2007,"9","124","0","0","1","125"
"Sublette",2007,"10","117","1","1","0","119"
"Sublette",2007,"11","102","0","2","2","106"
"Sublette",2007,"12","77","2","1","0","80"
"Sublette",2007,"13","107","0","2","0","109"
"Sublette",2007,"14","117","0","1","0","118"
"Sublette",2007,"15","122","2","2","2","128"
"Sublette",2007,"16","125","1","2","0","128"
"Sublette",2007,"17","131","1","3","0","135"
"Sublette",2007,"18 to 20","256","3","7","3","269"
"Sublette",2007,"21 to 24","355","3","3","10","371"
"Sublette",2007,"25 & over","5981","38","50","24","6093"
"Sublette",2007,"Total","8611","58","84","47","8800"
"Sweetwater",2015,"0","576","16","9","12","613"
"Sweetwater",2015,"1","600","16","23","8","647"
"Sweetwater",2015,"2","646","16","7","10","679"
"Sweetwater",2015,"3","548","18","10","5","581"
"Sweetwater",2015,"4","635","9","8","7","659"
"Sweetwater",2015,"5","627","17","16","5","665"
"Sweetwater",2015,"6","723","19","9","8","759"
"Sweetwater",2015,"7","695","17","14","11","737"
"Sweetwater",2015,"8","715","13","13","5","746"
"Sweetwater",2015,"9","704","14","13","3","734"
"Sweetwater",2015,"10","659","13","14","5","691"
"Sweetwater",2015,"11","646","10","11","9","676"
"Sweetwater",2015,"12","633","16","16","9","674"
"Sweetwater",2015,"13","637","14","11","6","668"
"Sweetwater",2015,"14","600","12","12","10","634"
"Sweetwater",2015,"15","619","10","12","7","648"
"Sweetwater",2015,"16","609","12","7","4","632"
"Sweetwater",2015,"17","587","8","14","4","613"
"Sweetwater",2015,"18 to 20","1579","35","39","20","1673"
"Sweetwater",2015,"21 to 24","2173","59","36","39","2307"
"Sweetwater",2015,"25 & over","27499","437","428","293","28657"
"Sweetwater",2015,"Total","42710","781","722","480","44693"
"Niobrara",1999,"0","16","0","0","0","16"
"Niobrara",1999,"1","27","0","0","0","27"
"Niobrara",1999,"2","22","0","0","0","22"
"Niobrara",1999,"3","32","0","0","0","32"
"Niobrara",1999,"4","23","0","0","0","23"
"Niobrara",1999,"5","32","0","0","0","32"
"Niobrara",1999,"6","22","0","0","0","22"
"Niobrara",1999,"7","36","0","0","0","36"
"Niobrara",1999,"8","28","0","0","0","28"
"Niobrara",1999,"9","34","0","0","0","34"
"Niobrara",1999,"10","33","0","0","0","33"
"Niobrara",1999,"11","37","0","0","0","37"
"Niobrara",1999,"12","32","0","0","0","32"
"Niobrara",1999,"13","38","0","0","0","38"
"Niobrara",1999,"14","36","0","0","0","36"
"Niobrara",1999,"15","39","0","0","0","39"
"Niobrara",1999,"16","32","0","0","0","32"
"Niobrara",1999,"17","41","0","0","0","41"
"Niobrara",1999,"18 to 20","81","1","0","0","82"
"Niobrara",1999,"21 to 24","68","0","0","0","68"
"Niobrara",1999,"25 & over","1741","1","2","0","1744"
"Niobrara",1999,"Total","2450","2","2","0","2454"
"Johnson",2016,"0","79","0","1","2","82"
"Johnson",2016,"1","71","1","1","0","73"
"Johnson",2016,"2","94","3","3","2","102"
"Johnson",2016,"3","86","0","3","1","90"
"Johnson",2016,"4","87","5","4","3","99"
"Johnson",2016,"5","106","5","8","2","121"
"Johnson",2016,"6","88","2","10","4","104"
"Johnson",2016,"7","107","3","5","3","118"
"Johnson",2016,"8","100","3","5","4","112"
"Johnson",2016,"9","115","1","3","1","120"
"Johnson",2016,"10","118","2","5","0","125"
"Johnson",2016,"11","119","2","2","1","124"
"Johnson",2016,"12","106","0","2","0","108"
"Johnson",2016,"13","85","3","2","0","90"
"Johnson",2016,"14","102","2","2","1","107"
"Johnson",2016,"15","94","1","1","0","96"
"Johnson",2016,"16","95","2","3","0","100"
"Johnson",2016,"17","92","1","2","0","95"
"Johnson",2016,"18 to 20","209","3","4","2","218"
"Johnson",2016,"21 to 24","282","3","6","4","295"
"Johnson",2016,"25 & over","5923","75","57","52","6107"
"Johnson",2016,"Total","8158","117","129","82","8486"
"Crook",2007,"0","107","1","0","0","108"
"Crook",2007,"1","76","0","0","0","76"
"Crook",2007,"2","77","2","0","1","80"
"Crook",2007,"3","82","1","1","1","85"
"Crook",2007,"4","53","0","1","1","55"
"Crook",2007,"5","78","2","0","0","80"
"Crook",2007,"6","72","1","2","0","75"
"Crook",2007,"7","90","2","0","0","92"
"Crook",2007,"8","79","1","1","0","81"
"Crook",2007,"9","65","1","2","0","68"
"Crook",2007,"10","68","1","0","0","69"
"Crook",2007,"11","100","1","2","0","103"
"Crook",2007,"12","75","0","0","0","75"
"Crook",2007,"13","91","0","1","0","92"
"Crook",2007,"14","102","0","0","0","102"
"Crook",2007,"15","97","0","3","0","100"
"Crook",2007,"16","114","1","0","0","115"
"Crook",2007,"17","101","0","1","0","102"
"Crook",2007,"18 to 20","218","1","1","0","220"
"Crook",2007,"21 to 24","255","0","3","0","258"
"Crook",2007,"25 & over","4535","7","34","5","4581"
"Crook",2007,"Total","6535","22","52","8","6617"
"Sublette",2014,"0","118","2","2","2","124"
"Sublette",2014,"1","143","2","0","1","146"
"Sublette",2014,"2","142","1","0","0","143"
"Sublette",2014,"3","138","2","0","0","140"
"Sublette",2014,"4","114","2","0","0","116"
"Sublette",2014,"5","137","4","1","1","143"
"Sublette",2014,"6","153","1","1","0","155"
"Sublette",2014,"7","128","1","3","1","133"
"Sublette",2014,"8","119","0","1","1","121"
"Sublette",2014,"9","117","2","1","1","121"
"Sublette",2014,"10","133","1","3","2","139"
"Sublette",2014,"11","134","0","1","0","135"
"Sublette",2014,"12","129","2","2","13","146"
"Sublette",2014,"13","110","1","2","16","129"
"Sublette",2014,"14","137","2","2","3","144"
"Sublette",2014,"15","129","1","1","2","133"
"Sublette",2014,"16","113","2","2","1","118"
"Sublette",2014,"17","134","3","3","0","140"
"Sublette",2014,"18 to 20","281","8","12","3","304"
"Sublette",2014,"21 to 24","364","9","3","5","381"
"Sublette",2014,"25 & over","6677","104","66","61","6908"
"Sublette",2014,"Total","9650","150","106","113","10019"
"Goshen",1990,"0","176","0","1","0","177"
"Goshen",1990,"1","152","1","7","0","160"
"Goshen",1990,"2","159","0","0","0","159"
"Goshen",1990,"3","175","0","0","0","175"
"Goshen",1990,"4","179","0","0","0","179"
"Goshen",1990,"5","194","2","2","0","198"
"Goshen",1990,"6","200","0","9","0","209"
"Goshen",1990,"7","184","0","4","0","188"
"Goshen",1990,"8","192","0","3","0","195"
"Goshen",1990,"9","231","0","2","0","233"
"Goshen",1990,"10","212","6","2","1","221"
"Goshen",1990,"11","182","0","6","0","188"
"Goshen",1990,"12","199","0","1","0","200"
"Goshen",1990,"13","201","0","0","0","201"
"Goshen",1990,"14","202","0","0","0","202"
"Goshen",1990,"15","207","0","7","0","214"
"Goshen",1990,"16","201","0","0","0","201"
"Goshen",1990,"17","188","0","1","0","189"
"Goshen",1990,"18 to 20","522","6","3","4","535"
"Goshen",1990,"21 to 24","483","0","0","1","484"
"Goshen",1990,"25 & over","7788","5","40","5","7838"
"Goshen",1990,"Total","12227","20","88","11","12346"
"Natrona",1990,"0","983","16","10","1","1010"
"Natrona",1990,"1","897","8","9","5","919"
"Natrona",1990,"2","871","12","7","1","891"
"Natrona",1990,"3","927","9","10","7","953"
"Natrona",1990,"4","1005","11","7","3","1026"
"Natrona",1990,"5","1031","8","9","7","1055"
"Natrona",1990,"6","1008","10","6","0","1024"
"Natrona",1990,"7","1093","15","7","8","1123"
"Natrona",1990,"8","1048","12","8","3","1071"
"Natrona",1990,"9","1062","10","8","13","1093"
"Natrona",1990,"10","1130","17","11","7","1165"
"Natrona",1990,"11","1040","6","6","3","1055"
"Natrona",1990,"12","957","8","7","6","978"
"Natrona",1990,"13","930","8","9","8","955"
"Natrona",1990,"14","876","9","6","7","898"
"Natrona",1990,"15","931","7","9","7","954"
"Natrona",1990,"16","848","7","4","5","864"
"Natrona",1990,"17","890","10","5","5","910"
"Natrona",1990,"18 to 20","2487","51","24","11","2573"
"Natrona",1990,"21 to 24","2535","18","26","7","2586"
"Natrona",1990,"25 & over","37562","213","262","156","38193"
"Natrona",1990,"Total","60111","465","450","270","61296"
"Platte",1991,"0","107","0","0","0","107"
"Platte",1991,"1","112","0","1","0","113"
"Platte",1991,"2","107","0","0","0","107"
"Platte",1991,"3","105","0","0","0","105"
"Platte",1991,"4","129","0","1","0","130"
"Platte",1991,"5","133","1","1","1","136"
"Platte",1991,"6","131","0","0","0","131"
"Platte",1991,"7","125","0","0","0","125"
"Platte",1991,"8","142","0","0","0","142"
"Platte",1991,"9","132","0","0","0","132"
"Platte",1991,"10","142","0","0","0","142"
"Platte",1991,"11","161","0","1","0","162"
"Platte",1991,"12","141","0","0","0","141"
"Platte",1991,"13","135","0","0","0","135"
"Platte",1991,"14","134","0","0","0","134"
"Platte",1991,"15","139","0","0","0","139"
"Platte",1991,"16","135","0","0","0","135"
"Platte",1991,"17","129","0","0","0","129"
"Platte",1991,"18 to 20","240","0","0","2","242"
"Platte",1991,"21 to 24","272","0","0","0","272"
"Platte",1991,"25 & over","5295","0","8","1","5304"
"Platte",1991,"Total","8146","1","12","4","8163"
"Campbell",1995,"0","449","0","4","3","456"
"Campbell",1995,"1","491","1","8","2","502"
"Campbell",1995,"2","508","2","4","0","514"
"Campbell",1995,"3","482","0","7","0","489"
"Campbell",1995,"4","517","2","9","0","528"
"Campbell",1995,"5","545","0","10","0","555"
"Campbell",1995,"6","555","0","6","1","562"
"Campbell",1995,"7","543","0","8","0","551"
"Campbell",1995,"8","557","3","4","1","565"
"Campbell",1995,"9","605","0","10","7","622"
"Campbell",1995,"10","624","4","13","5","646"
"Campbell",1995,"11","607","0","8","0","615"
"Campbell",1995,"12","682","0","17","4","703"
"Campbell",1995,"13","675","0","10","3","688"
"Campbell",1995,"14","668","0","6","0","674"
"Campbell",1995,"15","690","1","6","6","703"
"Campbell",1995,"16","631","3","8","1","643"
"Campbell",1995,"17","599","1","12","3","615"
"Campbell",1995,"18 to 20","1203","1","15","0","1219"
"Campbell",1995,"21 to 24","1435","3","30","11","1479"
"Campbell",1995,"25 & over","17884","18","160","49","18111"
"Campbell",1995,"Total","30950","39","355","96","31440"
"Campbell",2009,"0","827","5","27","6","865"
"Campbell",2009,"1","740","11","25","2","778"
"Campbell",2009,"2","831","4","18","3","856"
"Campbell",2009,"3","754","5","18","2","779"
"Campbell",2009,"4","700","3","13","5","721"
"Campbell",2009,"5","689","2","17","0","708"
"Campbell",2009,"6","726","8","15","4","753"
"Campbell",2009,"7","659","4","21","10","694"
"Campbell",2009,"8","622","10","19","1","652"
"Campbell",2009,"9","674","5","7","7","693"
"Campbell",2009,"10","672","5","14","8","699"
"Campbell",2009,"11","646","4","17","5","672"
"Campbell",2009,"12","678","7","7","3","695"
"Campbell",2009,"13","666","11","16","2","695"
"Campbell",2009,"14","586","8","9","5","608"
"Campbell",2009,"15","655","3","13","2","673"
"Campbell",2009,"16","644","5","16","3","668"
"Campbell",2009,"17","623","6","16","3","648"
"Campbell",2009,"18 to 20","1717","32","50","27","1826"
"Campbell",2009,"21 to 24","2793","15","49","19","2876"
"Campbell",2009,"25 & over","27405","114","378","194","28091"
"Campbell",2009,"Total","44307","267","765","311","45650"
"Campbell",1998,"0","447","0","7","2","456"
"Campbell",1998,"1","498","2","10","3","513"
"Campbell",1998,"2","516","2","3","0","521"
"Campbell",1998,"3","454","0","5","0","459"
"Campbell",1998,"4","489","2","5","0","496"
"Campbell",1998,"5","502","0","7","0","509"
"Campbell",1998,"6","534","0","8","2","544"
"Campbell",1998,"7","526","0","10","0","536"
"Campbell",1998,"8","561","6","4","2","573"
"Campbell",1998,"9","576","0","12","8","596"
"Campbell",1998,"10","550","4","12","4","570"
"Campbell",1998,"11","575","0","6","0","581"
"Campbell",1998,"12","638","0","9","8","655"
"Campbell",1998,"13","661","0","17","5","683"
"Campbell",1998,"14","656","0","8","0","664"
"Campbell",1998,"15","716","2","6","7","731"
"Campbell",1998,"16","693","3","13","1","710"
"Campbell",1998,"17","639","1","16","4","660"
"Campbell",1998,"18 to 20","1369","4","18","0","1391"
"Campbell",1998,"21 to 24","1581","3","22","11","1617"
"Campbell",1998,"25 & over","18753","10","167","57","18987"
"Campbell",1998,"Total","31934","39","365","114","32452"
"Washakie",1998,"0","96","0","0","1","97"
"Washakie",1998,"1","110","0","2","0","112"
"Washakie",1998,"2","105","0","0","1","106"
"Washakie",1998,"3","100","0","0","0","100"
"Washakie",1998,"4","99","0","0","0","99"
"Washakie",1998,"5","104","0","6","3","113"
"Washakie",1998,"6","101","0","0","1","102"
"Washakie",1998,"7","116","0","0","0","116"
"Washakie",1998,"8","145","0","0","0","145"
"Washakie",1998,"9","139","0","0","0","139"
"Washakie",1998,"10","156","0","0","1","157"
"Washakie",1998,"11","138","0","0","0","138"
"Washakie",1998,"12","144","0","1","3","148"
"Washakie",1998,"13","149","0","1","0","150"
"Washakie",1998,"14","164","0","2","0","166"
"Washakie",1998,"15","174","0","5","0","179"
"Washakie",1998,"16","196","0","0","0","196"
"Washakie",1998,"17","153","0","0","1","154"
"Washakie",1998,"18 to 20","284","1","1","0","286"
"Washakie",1998,"21 to 24","281","0","0","0","281"
"Washakie",1998,"25 & over","5556","1","22","22","5601"
"Washakie",1998,"Total","8510","2","40","33","8585"
"Park",2005,"0","274","3","3","2","282"
"Park",2005,"1","272","4","2","0","278"
"Park",2005,"2","295","2","3","2","302"
"Park",2005,"3","268","2","0","3","273"
"Park",2005,"4","250","0","2","2","254"
"Park",2005,"5","266","1","1","1","269"
"Park",2005,"6","248","1","2","1","252"
"Park",2005,"7","293","2","2","2","299"
"Park",2005,"8","288","2","3","1","294"
"Park",2005,"9","323","3","0","1","327"
"Park",2005,"10","293","3","4","1","301"
"Park",2005,"11","298","1","3","1","303"
"Park",2005,"12","335","3","7","5","350"
"Park",2005,"13","339","6","2","3","350"
"Park",2005,"14","360","2","1","4","367"
"Park",2005,"15","392","2","2","3","399"
"Park",2005,"16","382","0","4","1","387"
"Park",2005,"17","384","2","2","1","389"
"Park",2005,"18 to 20","1269","11","17","19","1316"
"Park",2005,"21 to 24","1245","4","8","14","1271"
"Park",2005,"25 & over","17890","25","101","93","18109"
"Park",2005,"Total","25964","79","169","160","26372"
"Uinta",1998,"0","314","1","2","0","317"
"Uinta",1998,"1","345","1","5","2","353"
"Uinta",1998,"2","328","0","1","0","329"
"Uinta",1998,"3","315","0","0","3","318"
"Uinta",1998,"4","358","2","2","2","364"
"Uinta",1998,"5","319","4","2","2","327"
"Uinta",1998,"6","365","2","3","3","373"
"Uinta",1998,"7","336","0","7","3","346"
"Uinta",1998,"8","357","2","1","0","360"
"Uinta",1998,"9","362","0","3","3","368"
"Uinta",1998,"10","405","1","4","5","415"
"Uinta",1998,"11","382","1","2","0","385"
"Uinta",1998,"12","438","1","6","0","445"
"Uinta",1998,"13","444","1","2","2","449"
"Uinta",1998,"14","446","1","6","0","453"
"Uinta",1998,"15","449","2","8","0","459"
"Uinta",1998,"16","497","0","14","4","515"
"Uinta",1998,"17","448","0","3","1","452"
"Uinta",1998,"18 to 20","876","0","5","5","886"
"Uinta",1998,"21 to 24","866","0","9","0","875"
"Uinta",1998,"25 & over","11132","5","72","31","11240"
"Uinta",1998,"Total","19782","24","157","66","20029"
"Uinta",1993,"0","332","1","1","0","334"
"Uinta",1993,"1","367","2","2","1","372"
"Uinta",1993,"2","339","0","2","0","341"
"Uinta",1993,"3","348","0","0","3","351"
"Uinta",1993,"4","369","2","2","3","376"
"Uinta",1993,"5","367","4","0","1","372"
"Uinta",1993,"6","422","2","2","3","429"
"Uinta",1993,"7","402","0","6","4","412"
"Uinta",1993,"8","420","1","2","0","423"
"Uinta",1993,"9","433","0","2","5","440"
"Uinta",1993,"10","477","3","6","6","492"
"Uinta",1993,"11","467","0","4","0","471"
"Uinta",1993,"12","476","0","4","0","480"
"Uinta",1993,"13","485","0","4","2","491"
"Uinta",1993,"14","460","0","5","0","465"
"Uinta",1993,"15","433","1","7","0","441"
"Uinta",1993,"16","439","0","3","2","444"
"Uinta",1993,"17","385","0","2","1","388"
"Uinta",1993,"18 to 20","726","0","2","7","735"
"Uinta",1993,"21 to 24","775","0","12","0","787"
"Uinta",1993,"25 & over","10438","6","66","27","10537"
"Uinta",1993,"Total","19360","22","134","65","19581"
"Johnson",1992,"0","69","0","1","0","70"
"Johnson",1992,"1","81","0","0","0","81"
"Johnson",1992,"2","74","0","0","0","74"
"Johnson",1992,"3","72","0","0","0","72"
"Johnson",1992,"4","76","0","0","0","76"
"Johnson",1992,"5","81","0","1","0","82"
"Johnson",1992,"6","84","0","3","0","87"
"Johnson",1992,"7","90","0","0","0","90"
"Johnson",1992,"8","89","0","4","0","93"
"Johnson",1992,"9","105","0","1","0","106"
"Johnson",1992,"10","111","0","1","0","112"
"Johnson",1992,"11","111","0","0","0","111"
"Johnson",1992,"12","101","0","0","0","101"
"Johnson",1992,"13","95","0","2","0","97"
"Johnson",1992,"14","99","0","4","0","103"
"Johnson",1992,"15","97","0","3","1","101"
"Johnson",1992,"16","111","0","0","0","111"
"Johnson",1992,"17","97","0","0","0","97"
"Johnson",1992,"18 to 20","202","0","0","0","202"
"Johnson",1992,"21 to 24","188","0","0","0","188"
"Johnson",1992,"25 & over","4214","0","12","0","4226"
"Johnson",1992,"Total","6247","0","32","1","6280"
"Washakie",2009,"0","104","2","1","0","107"
"Washakie",2009,"1","106","5","2","1","114"
"Washakie",2009,"2","100","0","1","2","103"
"Washakie",2009,"3","126","0","1","1","128"
"Washakie",2009,"4","113","0","6","0","119"
"Washakie",2009,"5","101","0","2","1","104"
"Washakie",2009,"6","134","0","1","0","135"
"Washakie",2009,"7","104","0","3","1","108"
"Washakie",2009,"8","138","0","1","0","139"
"Washakie",2009,"9","97","2","1","0","100"
"Washakie",2009,"10","119","2","1","1","123"
"Washakie",2009,"11","115","1","3","1","120"
"Washakie",2009,"12","93","0","7","0","100"
"Washakie",2009,"13","110","0","2","2","114"
"Washakie",2009,"14","99","0","5","0","104"
"Washakie",2009,"15","109","2","3","3","117"
"Washakie",2009,"16","124","2","1","1","128"
"Washakie",2009,"17","130","3","5","3","141"
"Washakie",2009,"18 to 20","240","2","6","2","250"
"Washakie",2009,"21 to 24","267","6","1","9","283"
"Washakie",2009,"25 & over","5645","28","74","39","5786"
"Washakie",2009,"Total","8174","55","127","67","8423"
"Teton",2015,"0","237","0","4","3","244"
"Teton",2015,"1","236","2","0","0","238"
"Teton",2015,"2","244","5","1","1","251"
"Teton",2015,"3","227","3","0","2","232"
"Teton",2015,"4","241","1","0","4","246"
"Teton",2015,"5","262","5","6","3","276"
"Teton",2015,"6","274","3","4","3","284"
"Teton",2015,"7","259","6","4","6","275"
"Teton",2015,"8","276","2","2","2","282"
"Teton",2015,"9","239","3","5","3","250"
"Teton",2015,"10","237","2","2","5","246"
"Teton",2015,"11","221","3","3","4","231"
"Teton",2015,"12","220","4","3","6","233"
"Teton",2015,"13","214","3","2","4","223"
"Teton",2015,"14","197","1","2","7","207"
"Teton",2015,"15","207","2","5","3","217"
"Teton",2015,"16","187","0","3","2","192"
"Teton",2015,"17","207","2","2","5","216"
"Teton",2015,"18 to 20","452","10","8","12","482"
"Teton",2015,"21 to 24","883","13","14","20","930"
"Teton",2015,"25 & over","16748","153","169","248","17318"
"Teton",2015,"Total","22268","223","239","343","23073"
"Converse",1996,"0","158","0","0","0","158"
"Converse",1996,"1","137","2","3","0","142"
"Converse",1996,"2","147","0","0","0","147"
"Converse",1996,"3","166","0","0","0","166"
"Converse",1996,"4","174","0","4","0","178"
"Converse",1996,"5","185","0","3","1","189"
"Converse",1996,"6","166","0","0","0","166"
"Converse",1996,"7","189","3","3","0","195"
"Converse",1996,"8","188","0","0","0","188"
"Converse",1996,"9","210","0","4","1","215"
"Converse",1996,"10","200","0","0","3","203"
"Converse",1996,"11","213","0","3","0","216"
"Converse",1996,"12","224","0","4","0","228"
"Converse",1996,"13","242","0","0","0","242"
"Converse",1996,"14","252","4","6","1","263"
"Converse",1996,"15","234","1","0","1","236"
"Converse",1996,"16","230","0","4","0","234"
"Converse",1996,"17","258","0","2","0","260"
"Converse",1996,"18 to 20","393","0","6","0","399"
"Converse",1996,"21 to 24","430","0","4","0","434"
"Converse",1996,"25 & over","7326","4","57","10","7397"
"Converse",1996,"Total","11722","14","103","17","11856"
"Laramie",2001,"0","1026","88","31","22","1167"
"Laramie",2001,"1","988","68","18","25","1099"
"Laramie",2001,"2","991","45","17","27","1080"
"Laramie",2001,"3","978","68","21","15","1082"
"Laramie",2001,"4","1009","46","19","14","1088"
"Laramie",2001,"5","987","42","13","14","1056"
"Laramie",2001,"6","1063","53","13","14","1143"
"Laramie",2001,"7","1083","41","22","16","1162"
"Laramie",2001,"8","1143","54","16","27","1240"
"Laramie",2001,"9","1098","51","11","14","1174"
"Laramie",2001,"10","1112","51","21","19","1203"
"Laramie",2001,"11","1165","40","25","10","1240"
"Laramie",2001,"12","1127","49","16","13","1205"
"Laramie",2001,"13","1110","44","13","20","1187"
"Laramie",2001,"14","1154","36","16","17","1223"
"Laramie",2001,"15","1179","45","16","15","1255"
"Laramie",2001,"16","1203","42","12","15","1272"
"Laramie",2001,"17","1159","35","14","19","1227"
"Laramie",2001,"18 to 20","3193","228","46","70","3537"
"Laramie",2001,"21 to 24","4144","268","81","87","4580"
"Laramie",2001,"25 & over","50773","1321","574","666","53334"
"Laramie",2001,"Total","77685","2715","1015","1139","82554"
"Sublette",1999,"0","62","0","0","0","62"
"Sublette",1999,"1","72","0","1","2","75"
"Sublette",1999,"2","63","0","0","0","63"
"Sublette",1999,"3","75","0","0","0","75"
"Sublette",1999,"4","71","0","0","0","71"
"Sublette",1999,"5","66","0","1","0","67"
"Sublette",1999,"6","86","0","0","0","86"
"Sublette",1999,"7","81","0","0","0","81"
"Sublette",1999,"8","81","0","2","0","83"
"Sublette",1999,"9","82","0","0","0","82"
"Sublette",1999,"10","85","0","3","0","88"
"Sublette",1999,"11","100","0","0","0","100"
"Sublette",1999,"12","97","0","0","0","97"
"Sublette",1999,"13","111","0","0","0","111"
"Sublette",1999,"14","95","0","0","0","95"
"Sublette",1999,"15","91","0","0","0","91"
"Sublette",1999,"16","101","0","0","0","101"
"Sublette",1999,"17","92","0","0","0","92"
"Sublette",1999,"18 to 20","164","0","0","0","164"
"Sublette",1999,"21 to 24","197","0","2","0","199"
"Sublette",1999,"25 & over","3930","3","17","2","3952"
"Sublette",1999,"Total","5802","3","26","4","5835"
"Fremont",1996,"0","314","0","143","1","458"
"Fremont",1996,"1","308","7","146","0","461"
"Fremont",1996,"2","327","0","134","2","463"
"Fremont",1996,"3","323","0","173","0","496"
"Fremont",1996,"4","334","0","202","3","539"
"Fremont",1996,"5","351","0","199","2","552"
"Fremont",1996,"6","396","0","176","0","572"
"Fremont",1996,"7","369","0","169","1","539"
"Fremont",1996,"8","382","0","151","2","535"
"Fremont",1996,"9","428","0","155","2","585"
"Fremont",1996,"10","403","3","148","5","559"
"Fremont",1996,"11","449","0","212","3","664"
"Fremont",1996,"12","457","0","163","0","620"
"Fremont",1996,"13","510","3","200","0","713"
"Fremont",1996,"14","536","0","169","0","705"
"Fremont",1996,"15","493","0","148","1","642"
"Fremont",1996,"16","508","5","167","1","681"
"Fremont",1996,"17","483","0","156","0","639"
"Fremont",1996,"18 to 20","1051","2","364","2","1419"
"Fremont",1996,"21 to 24","1012","4","414","8","1438"
"Fremont",1996,"25 & over","18995","22","3269","54","22340"
"Fremont",1996,"Total","28429","46","7058","87","35620"
"Weston",1994,"0","65","0","2","0","67"
"Weston",1994,"1","78","0","0","0","78"
"Weston",1994,"2","79","0","3","0","82"
"Weston",1994,"3","79","0","1","0","80"
"Weston",1994,"4","85","0","3","0","88"
"Weston",1994,"5","83","0","0","0","83"
"Weston",1994,"6","90","0","0","0","90"
"Weston",1994,"7","96","0","0","0","96"
"Weston",1994,"8","97","0","0","0","97"
"Weston",1994,"9","114","0","5","0","119"
"Weston",1994,"10","113","0","4","0","117"
"Weston",1994,"11","134","0","2","0","136"
"Weston",1994,"12","121","0","0","0","121"
"Weston",1994,"13","133","0","0","0","133"
"Weston",1994,"14","119","0","0","0","119"
"Weston",1994,"15","128","0","0","0","128"
"Weston",1994,"16","107","0","0","0","107"
"Weston",1994,"17","106","0","2","0","108"
"Weston",1994,"18 to 20","221","0","14","0","235"
"Weston",1994,"21 to 24","230","0","5","0","235"
"Weston",1994,"25 & over","4346","0","27","4","4377"
"Weston",1994,"Total","6624","0","68","4","6696"
"Fremont",1995,"0","314","0","138","1","453"
"Fremont",1995,"1","313","5","145","0","463"
"Fremont",1995,"2","334","0","160","3","497"
"Fremont",1995,"3","334","0","207","0","541"
"Fremont",1995,"4","350","0","196","3","549"
"Fremont",1995,"5","373","1","175","2","551"
"Fremont",1995,"6","392","0","173","0","565"
"Fremont",1995,"7","374","0","160","2","536"
"Fremont",1995,"8","399","0","149","1","549"
"Fremont",1995,"9","452","0","168","1","621"
"Fremont",1995,"10","428","3","168","5","604"
"Fremont",1995,"11","453","0","186","2","641"
"Fremont",1995,"12","484","0","177","0","661"
"Fremont",1995,"13","522","4","191","0","717"
"Fremont",1995,"14","525","0","170","0","695"
"Fremont",1995,"15","497","0","162","2","661"
"Fremont",1995,"16","482","3","151","2","638"
"Fremont",1995,"17","468","0","136","0","604"
"Fremont",1995,"18 to 20","1007","2","334","2","1345"
"Fremont",1995,"21 to 24","1016","5","441","10","1472"
"Fremont",1995,"25 & over","18819","19","3167","51","22056"
"Fremont",1995,"Total","28336","42","6954","87","35419"
"Lincoln",2010,"0","271","1","1","1","274"
"Lincoln",2010,"1","264","1","2","0","267"
"Lincoln",2010,"2","286","1","5","0","292"
"Lincoln",2010,"3","298","2","2","0","302"
"Lincoln",2010,"4","309","2","2","1","314"
"Lincoln",2010,"5","273","2","4","2","281"
"Lincoln",2010,"6","257","1","5","0","263"
"Lincoln",2010,"7","282","0","6","0","288"
"Lincoln",2010,"8","269","3","3","0","275"
"Lincoln",2010,"9","261","3","4","0","268"
"Lincoln",2010,"10","288","2","5","1","296"
"Lincoln",2010,"11","291","4","5","0","300"
"Lincoln",2010,"12","283","1","2","2","288"
"Lincoln",2010,"13","263","3","4","3","273"
"Lincoln",2010,"14","261","2","4","1","268"
"Lincoln",2010,"15","251","3","4","1","259"
"Lincoln",2010,"16","277","3","4","2","286"
"Lincoln",2010,"17","291","3","5","0","299"
"Lincoln",2010,"18 to 20","505","1","4","2","512"
"Lincoln",2010,"21 to 24","609","7","10","1","627"
"Lincoln",2010,"25 & over","11677","33","98","50","11858"
"Lincoln",2010,"Total","17766","78","179","67","18090"
"Carbon",2014,"0","196","4","3","1","204"
"Carbon",2014,"1","188","3","9","1","201"
"Carbon",2014,"2","210","6","1","0","217"
"Carbon",2014,"3","212","6","4","3","225"
"Carbon",2014,"4","208","6","6","1","221"
"Carbon",2014,"5","220","4","4","0","228"
"Carbon",2014,"6","234","6","5","1","246"
"Carbon",2014,"7","224","3","2","4","233"
"Carbon",2014,"8","213","5","3","1","222"
"Carbon",2014,"9","185","3","3","5","196"
"Carbon",2014,"10","193","6","2","2","203"
"Carbon",2014,"11","202","4","2","1","209"
"Carbon",2014,"12","182","4","5","4","195"
"Carbon",2014,"13","192","1","7","3","203"
"Carbon",2014,"14","189","4","4","1","198"
"Carbon",2014,"15","203","1","4","1","209"
"Carbon",2014,"16","188","2","4","2","196"
"Carbon",2014,"17","194","4","2","2","202"
"Carbon",2014,"18 to 20","430","14","15","5","464"
"Carbon",2014,"21 to 24","744","22","16","19","801"
"Carbon",2014,"25 & over","10265","169","197","125","10756"
"Carbon",2014,"Total","15072","277","298","182","15829"
"Hot Springs",2012,"0","56","1","0","0","57"
"Hot Springs",2012,"1","58","2","0","0","60"
"Hot Springs",2012,"2","41","1","0","0","42"
"Hot Springs",2012,"3","48","0","0","0","48"
"Hot Springs",2012,"4","51","0","0","0","51"
"Hot Springs",2012,"5","67","1","1","0","69"
"Hot Springs",2012,"6","46","0","0","0","46"
"Hot Springs",2012,"7","53","0","1","0","54"
"Hot Springs",2012,"8","47","0","1","0","48"
"Hot Springs",2012,"9","49","3","1","1","54"
"Hot Springs",2012,"10","57","0","1","0","58"
"Hot Springs",2012,"11","51","0","1","1","53"
"Hot Springs",2012,"12","60","1","0","0","61"
"Hot Springs",2012,"13","56","1","2","0","59"
"Hot Springs",2012,"14","55","0","0","1","56"
"Hot Springs",2012,"15","55","0","1","1","57"
"Hot Springs",2012,"16","52","2","2","1","57"
"Hot Springs",2012,"17","51","1","1","1","54"
"Hot Springs",2012,"18 to 20","124","5","4","2","135"
"Hot Springs",2012,"21 to 24","148","4","8","2","162"
"Hot Springs",2012,"25 & over","3481","21","46","14","3562"
"Hot Springs",2012,"Total","4706","43","70","24","4843"
"Carbon",1990,"0","203","0","0","1","204"
"Carbon",1990,"1","222","0","3","1","226"
"Carbon",1990,"2","222","3","0","0","225"
"Carbon",1990,"3","224","0","5","0","229"
"Carbon",1990,"4","260","0","0","0","260"
"Carbon",1990,"5","289","2","7","0","298"
"Carbon",1990,"6","288","1","1","0","290"
"Carbon",1990,"7","292","1","0","2","295"
"Carbon",1990,"8","264","3","7","2","276"
"Carbon",1990,"9","287","1","0","4","292"
"Carbon",1990,"10","315","3","3","3","324"
"Carbon",1990,"11","303","2","5","0","310"
"Carbon",1990,"12","311","3","0","1","315"
"Carbon",1990,"13","275","0","0","0","275"
"Carbon",1990,"14","290","0","0","3","293"
"Carbon",1990,"15","270","1","0","2","273"
"Carbon",1990,"16","264","0","0","2","266"
"Carbon",1990,"17","282","0","1","2","285"
"Carbon",1990,"18 to 20","542","5","7","2","556"
"Carbon",1990,"21 to 24","659","2","11","4","676"
"Carbon",1990,"25 & over","10265","58","78","39","10440"
"Carbon",1990,"Total","16327","85","128","68","16608"
"Big Horn",2011,"0","146","1","2","2","151"
"Big Horn",2011,"1","143","3","5","0","151"
"Big Horn",2011,"2","150","1","2","0","153"
"Big Horn",2011,"3","146","1","1","0","148"
"Big Horn",2011,"4","166","0","3","0","169"
"Big Horn",2011,"5","169","0","1","2","172"
"Big Horn",2011,"6","186","0","1","1","188"
"Big Horn",2011,"7","153","0","0","1","154"
"Big Horn",2011,"8","159","0","2","3","164"
"Big Horn",2011,"9","155","2","0","0","157"
"Big Horn",2011,"10","152","1","3","2","158"
"Big Horn",2011,"11","170","0","4","2","176"
"Big Horn",2011,"12","158","2","1","0","161"
"Big Horn",2011,"13","175","2","0","2","179"
"Big Horn",2011,"14","174","0","0","2","176"
"Big Horn",2011,"15","175","4","2","0","181"
"Big Horn",2011,"16","192","2","2","3","199"
"Big Horn",2011,"17","174","2","0","0","176"
"Big Horn",2011,"18 to 20","392","7","9","3","411"
"Big Horn",2011,"21 to 24","431","5","18","0","454"
"Big Horn",2011,"25 & over","7690","41","102","31","7864"
"Big Horn",2011,"Total","11456","74","158","54","11742"
"Niobrara",2012,"0","17","0","1","0","18"
"Niobrara",2012,"1","18","0","0","0","18"
"Niobrara",2012,"2","23","0","0","0","23"
"Niobrara",2012,"3","22","0","0","0","22"
"Niobrara",2012,"4","18","0","0","0","18"
"Niobrara",2012,"5","21","0","0","0","21"
"Niobrara",2012,"6","18","0","1","0","19"
"Niobrara",2012,"7","15","0","0","0","15"
"Niobrara",2012,"8","20","0","0","0","20"
"Niobrara",2012,"9","32","1","0","0","33"
"Niobrara",2012,"10","28","0","0","0","28"
"Niobrara",2012,"11","32","0","0","0","32"
"Niobrara",2012,"12","23","1","0","0","24"
"Niobrara",2012,"13","36","0","0","0","36"
"Niobrara",2012,"14","27","0","0","0","27"
"Niobrara",2012,"15","31","0","0","0","31"
"Niobrara",2012,"16","26","0","0","1","27"
"Niobrara",2012,"17","28","0","0","0","28"
"Niobrara",2012,"18 to 20","64","0","0","1","65"
"Niobrara",2012,"21 to 24","94","5","3","0","102"
"Niobrara",2012,"25 & over","1822","16","21","8","1867"
"Niobrara",2012,"Total","2415","23","26","10","2474"
"Natrona",2005,"0","919","18","21","7","965"
"Natrona",2005,"1","957","36","10","7","1010"
"Natrona",2005,"2","899","24","16","7","946"
"Natrona",2005,"3","886","38","23","11","958"
"Natrona",2005,"4","850","40","29","7","926"
"Natrona",2005,"5","796","31","18","7","852"
"Natrona",2005,"6","871","14","14","13","912"
"Natrona",2005,"7","816","24","17","9","866"
"Natrona",2005,"8","834","25","11","3","873"
"Natrona",2005,"9","872","18","11","10","911"
"Natrona",2005,"10","968","20","15","10","1013"
"Natrona",2005,"11","898","23","10","9","940"
"Natrona",2005,"12","924","19","18","4","965"
"Natrona",2005,"13","939","19","26","8","992"
"Natrona",2005,"14","966","12","16","11","1005"
"Natrona",2005,"15","1079","7","18","5","1109"
"Natrona",2005,"16","948","13","17","5","983"
"Natrona",2005,"17","943","11","22","10","986"
"Natrona",2005,"18 to 20","2939","54","45","27","3065"
"Natrona",2005,"21 to 24","4010","58","68","38","4174"
"Natrona",2005,"25 & over","44197","430","508","336","45471"
"Natrona",2005,"Total","67511","934","933","544","69922"
"Weston",2006,"0","66","0","3","1","70"
"Weston",2006,"1","73","1","1","1","76"
"Weston",2006,"2","69","1","2","1","73"
"Weston",2006,"3","60","2","3","0","65"
"Weston",2006,"4","65","1","2","0","68"
"Weston",2006,"5","76","2","2","0","80"
"Weston",2006,"6","76","0","2","0","78"
"Weston",2006,"7","69","1","1","1","72"
"Weston",2006,"8","71","2","2","1","76"
"Weston",2006,"9","80","0","1","0","81"
"Weston",2006,"10","68","1","0","1","70"
"Weston",2006,"11","66","0","2","0","68"
"Weston",2006,"12","74","0","2","0","76"
"Weston",2006,"13","73","2","2","0","77"
"Weston",2006,"14","80","0","1","0","81"
"Weston",2006,"15","101","0","1","0","102"
"Weston",2006,"16","97","0","1","0","98"
"Weston",2006,"17","107","0","0","0","107"
"Weston",2006,"18 to 20","240","2","8","1","251"
"Weston",2006,"21 to 24","339","3","3","1","346"
"Weston",2006,"25 & over","4610","14","62","16","4702"
"Weston",2006,"Total","6560","32","101","24","6717"
"Uinta",2008,"0","344","4","18","2","368"
"Uinta",2008,"1","314","2","2","2","320"
"Uinta",2008,"2","387","2","3","0","392"
"Uinta",2008,"3","289","2","2","0","293"
"Uinta",2008,"4","350","3","3","4","360"
"Uinta",2008,"5","384","2","2","5","393"
"Uinta",2008,"6","352","2","10","0","364"
"Uinta",2008,"7","302","2","5","1","310"
"Uinta",2008,"8","355","7","2","2","366"
"Uinta",2008,"9","314","6","0","2","322"
"Uinta",2008,"10","314","2","4","2","322"
"Uinta",2008,"11","304","4","5","5","318"
"Uinta",2008,"12","373","1","5","1","380"
"Uinta",2008,"13","314","1","3","1","319"
"Uinta",2008,"14","317","2","6","4","329"
"Uinta",2008,"15","323","4","3","1","331"
"Uinta",2008,"16","334","4","6","2","346"
"Uinta",2008,"17","333","4","5","2","344"
"Uinta",2008,"18 to 20","791","9","21","3","824"
"Uinta",2008,"21 to 24","885","1","8","6","900"
"Uinta",2008,"25 & over","12467","36","147","62","12712"
"Uinta",2008,"Total","20146","100","260","107","20613"
"Converse",2008,"0","177","1","11","1","190"
"Converse",2008,"1","188","4","1","1","194"
"Converse",2008,"2","178","1","4","0","183"
"Converse",2008,"3","175","5","3","2","185"
"Converse",2008,"4","161","3","6","0","170"
"Converse",2008,"5","220","3","1","1","225"
"Converse",2008,"6","194","1","2","0","197"
"Converse",2008,"7","168","2","4","1","175"
"Converse",2008,"8","166","0","3","0","169"
"Converse",2008,"9","173","2","0","1","176"
"Converse",2008,"10","182","2","0","1","185"
"Converse",2008,"11","171","4","1","0","176"
"Converse",2008,"12","176","4","2","0","182"
"Converse",2008,"13","177","2","2","0","181"
"Converse",2008,"14","179","5","2","1","187"
"Converse",2008,"15","190","1","0","0","191"
"Converse",2008,"16","245","2","3","0","250"
"Converse",2008,"17","199","4","2","1","206"
"Converse",2008,"18 to 20","430","2","3","1","436"
"Converse",2008,"21 to 24","581","3","3","2","589"
"Converse",2008,"25 & over","8891","28","83","37","9039"
"Converse",2008,"Total","13221","79","136","50","13486"
"Park",2012,"0","319","5","4","1","329"
"Park",2012,"1","281","8","2","4","295"
"Park",2012,"2","282","2","4","5","293"
"Park",2012,"3","331","4","3","2","340"
"Park",2012,"4","344","2","3","5","354"
"Park",2012,"5","336","5","2","4","347"
"Park",2012,"6","338","2","8","3","351"
"Park",2012,"7","350","3","1","1","355"
"Park",2012,"8","327","4","3","0","334"
"Park",2012,"9","332","3","5","2","342"
"Park",2012,"10","321","1","6","0","328"
"Park",2012,"11","314","0","3","0","317"
"Park",2012,"12","314","4","6","4","328"
"Park",2012,"13","309","2","3","4","318"
"Park",2012,"14","342","1","7","3","353"
"Park",2012,"15","325","5","8","7","345"
"Park",2012,"16","326","3","5","4","338"
"Park",2012,"17","336","5","3","4","348"
"Park",2012,"18 to 20","1205","58","26","26","1315"
"Park",2012,"21 to 24","1194","49","15","23","1281"
"Park",2012,"25 & over","19787","173","125","143","20228"
"Park",2012,"Total","28013","339","242","245","28839"
"Niobrara",2005,"0","11","1","0","0","12"
"Niobrara",2005,"1","11","0","0","0","11"
"Niobrara",2005,"2","24","0","0","0","24"
"Niobrara",2005,"3","14","0","0","0","14"
"Niobrara",2005,"4","24","0","1","0","25"
"Niobrara",2005,"5","22","0","0","0","22"
"Niobrara",2005,"6","20","0","0","0","20"
"Niobrara",2005,"7","27","0","0","0","27"
"Niobrara",2005,"8","25","0","0","0","25"
"Niobrara",2005,"9","35","0","0","0","35"
"Niobrara",2005,"10","23","0","0","0","23"
"Niobrara",2005,"11","22","0","0","0","22"
"Niobrara",2005,"12","24","1","0","0","25"
"Niobrara",2005,"13","32","0","0","0","32"
"Niobrara",2005,"14","36","0","0","1","37"
"Niobrara",2005,"15","34","0","0","0","34"
"Niobrara",2005,"16","36","0","0","0","36"
"Niobrara",2005,"17","32","0","0","1","33"
"Niobrara",2005,"18 to 20","58","0","0","0","58"
"Niobrara",2005,"21 to 24","87","1","2","0","90"
"Niobrara",2005,"25 & over","1685","5","16","4","1710"
"Niobrara",2005,"Total","2282","8","19","6","2315"
"Platte",2016,"0","80","2","0","2","84"
"Platte",2016,"1","86","1","0","2","89"
"Platte",2016,"2","81","3","1","1","86"
"Platte",2016,"3","80","1","2","2","85"
"Platte",2016,"4","115","5","2","1","123"
"Platte",2016,"5","86","2","0","1","89"
"Platte",2016,"6","80","2","1","1","84"
"Platte",2016,"7","101","2","2","1","106"
"Platte",2016,"8","90","1","1","0","92"
"Platte",2016,"9","95","3","0","3","101"
"Platte",2016,"10","93","1","0","1","95"
"Platte",2016,"11","98","2","0","0","100"
"Platte",2016,"12","91","0","0","0","91"
"Platte",2016,"13","99","1","2","2","104"
"Platte",2016,"14","106","0","2","0","108"
"Platte",2016,"15","97","2","0","0","99"
"Platte",2016,"16","98","1","3","0","102"
"Platte",2016,"17","104","0","0","0","104"
"Platte",2016,"18 to 20","229","5","3","7","244"
"Platte",2016,"21 to 24","325","2","8","5","340"
"Platte",2016,"25 & over","6215","55","48","36","6354"
"Platte",2016,"Total","8449","91","75","65","8680"
"Goshen",1994,"0","151","0","1","0","152"
"Goshen",1994,"1","142","2","7","0","151"
"Goshen",1994,"2","144","0","0","0","144"
"Goshen",1994,"3","157","0","0","0","157"
"Goshen",1994,"4","161","0","0","0","161"
"Goshen",1994,"5","150","2","3","0","155"
"Goshen",1994,"6","177","0","9","0","186"
"Goshen",1994,"7","150","0","1","0","151"
"Goshen",1994,"8","184","0","3","0","187"
"Goshen",1994,"9","213","0","2","0","215"
"Goshen",1994,"10","204","7","1","2","214"
"Goshen",1994,"11","199","0","7","0","206"
"Goshen",1994,"12","214","0","2","0","216"
"Goshen",1994,"13","214","0","0","0","214"
"Goshen",1994,"14","217","0","0","0","217"
"Goshen",1994,"15","213","0","6","0","219"
"Goshen",1994,"16","207","0","0","0","207"
"Goshen",1994,"17","194","0","2","0","196"
"Goshen",1994,"18 to 20","576","6","4","3","589"
"Goshen",1994,"21 to 24","518","0","0","3","521"
"Goshen",1994,"25 & over","8007","3","37","6","8053"
"Goshen",1994,"Total","12392","20","85","14","12511"
"Big Horn",1991,"0","146","0","0","0","146"
"Big Horn",1991,"1","149","0","2","0","151"
"Big Horn",1991,"2","167","0","0","0","167"
"Big Horn",1991,"3","157","0","0","0","157"
"Big Horn",1991,"4","156","0","2","0","158"
"Big Horn",1991,"5","152","0","5","2","159"
"Big Horn",1991,"6","174","0","0","0","174"
"Big Horn",1991,"7","183","0","0","0","183"
"Big Horn",1991,"8","185","0","0","0","185"
"Big Horn",1991,"9","211","0","0","0","211"
"Big Horn",1991,"10","196","0","3","0","199"
"Big Horn",1991,"11","188","0","1","0","189"
"Big Horn",1991,"12","199","0","1","0","200"
"Big Horn",1991,"13","185","0","0","0","185"
"Big Horn",1991,"14","197","0","0","1","198"
"Big Horn",1991,"15","176","0","2","0","178"
"Big Horn",1991,"16","189","0","0","0","189"
"Big Horn",1991,"17","190","0","2","3","195"
"Big Horn",1991,"18 to 20","326","0","5","0","331"
"Big Horn",1991,"21 to 24","352","0","0","0","352"
"Big Horn",1991,"25 & over","6630","0","33","12","6675"
"Big Horn",1991,"Total","10508","0","56","18","10582"
"Fremont",1999,"0","294","0","179","1","474"
"Fremont",1999,"1","301","7","181","0","489"
"Fremont",1999,"2","323","0","142","1","466"
"Fremont",1999,"3","301","0","168","0","469"
"Fremont",1999,"4","297","0","156","2","455"
"Fremont",1999,"5","321","2","157","1","481"
"Fremont",1999,"6","353","0","179","0","532"
"Fremont",1999,"7","337","0","195","1","533"
"Fremont",1999,"8","372","0","187","2","561"
"Fremont",1999,"9","404","0","174","2","580"
"Fremont",1999,"10","359","3","153","4","519"
"Fremont",1999,"11","398","0","194","4","596"
"Fremont",1999,"12","409","0","163","1","573"
"Fremont",1999,"13","462","3","188","1","654"
"Fremont",1999,"14","522","0","196","1","719"
"Fremont",1999,"15","462","0","150","1","613"
"Fremont",1999,"16","490","4","174","2","670"
"Fremont",1999,"17","485","0","162","0","647"
"Fremont",1999,"18 to 20","1136","4","451","4","1595"
"Fremont",1999,"21 to 24","979","4","402","11","1396"
"Fremont",1999,"25 & over","19183","20","3432","72","22707"
"Fremont",1999,"Total","28188","47","7383","111","35729"
"Hot Springs",2000,"0","47","0","1","0","48"
"Hot Springs",2000,"1","54","2","2","0","58"
"Hot Springs",2000,"2","35","3","5","1","44"
"Hot Springs",2000,"3","37","0","0","0","37"
"Hot Springs",2000,"4","45","1","1","0","47"
"Hot Springs",2000,"5","37","0","1","0","38"
"Hot Springs",2000,"6","46","0","1","0","47"
"Hot Springs",2000,"7","55","1","1","0","57"
"Hot Springs",2000,"8","48","0","1","0","49"
"Hot Springs",2000,"9","69","0","2","0","71"
"Hot Springs",2000,"10","62","0","0","0","62"
"Hot Springs",2000,"11","63","0","4","0","67"
"Hot Springs",2000,"12","67","0","2","1","70"
"Hot Springs",2000,"13","68","0","2","0","70"
"Hot Springs",2000,"14","81","1","2","0","84"
"Hot Springs",2000,"15","72","0","4","0","76"
"Hot Springs",2000,"16","78","0","3","0","81"
"Hot Springs",2000,"17","71","0","0","0","71"
"Hot Springs",2000,"18 to 20","155","0","5","1","161"
"Hot Springs",2000,"21 to 24","123","1","4","0","128"
"Hot Springs",2000,"25 & over","3424","8","44","9","3485"
"Hot Springs",2000,"Total","4737","17","85","12","4851"
"Natrona",1996,"0","832","13","11","2","858"
"Natrona",1996,"1","864","11","7","9","891"
"Natrona",1996,"2","814","10","13","2","839"
"Natrona",1996,"3","855","17","15","10","897"
"Natrona",1996,"4","886","13","12","6","917"
"Natrona",1996,"5","903","12","13","3","931"
"Natrona",1996,"6","950","18","11","1","980"
"Natrona",1996,"7","920","17","9","8","954"
"Natrona",1996,"8","933","14","10","3","960"
"Natrona",1996,"9","956","18","13","7","994"
"Natrona",1996,"10","1073","19","10","6","1108"
"Natrona",1996,"11","1060","11","11","5","1087"
"Natrona",1996,"12","1044","16","12","6","1078"
"Natrona",1996,"13","1087","12","19","10","1128"
"Natrona",1996,"14","1071","11","16","5","1103"
"Natrona",1996,"15","1125","17","16","9","1167"
"Natrona",1996,"16","1060","12","9","4","1085"
"Natrona",1996,"17","1068","11","8","4","1091"
"Natrona",1996,"18 to 20","3023","48","36","20","3127"
"Natrona",1996,"21 to 24","3139","36","37","15","3227"
"Natrona",1996,"25 & over","40645","264","351","177","41437"
"Natrona",1996,"Total","64308","600","639","312","65859"
"Lincoln",2011,"0","240","2","0","0","242"
"Lincoln",2011,"1","252","1","1","1","255"
"Lincoln",2011,"2","264","1","3","0","268"
"Lincoln",2011,"3","289","0","4","0","293"
"Lincoln",2011,"4","292","4","2","1","299"
"Lincoln",2011,"5","310","3","1","1","315"
"Lincoln",2011,"6","278","3","3","2","286"
"Lincoln",2011,"7","258","2","5","0","265"
"Lincoln",2011,"8","280","1","6","0","287"
"Lincoln",2011,"9","255","5","3","0","263"
"Lincoln",2011,"10","257","3","3","0","263"
"Lincoln",2011,"11","283","4","4","1","292"
"Lincoln",2011,"12","275","3","2","0","280"
"Lincoln",2011,"13","277","1","1","2","281"
"Lincoln",2011,"14","262","3","5","2","272"
"Lincoln",2011,"15","253","4","2","1","260"
"Lincoln",2011,"16","245","2","6","1","254"
"Lincoln",2011,"17","282","2","4","3","291"
"Lincoln",2011,"18 to 20","560","6","12","0","578"
"Lincoln",2011,"21 to 24","573","9","15","2","599"
"Lincoln",2011,"25 & over","11670","42","99","64","11875"
"Lincoln",2011,"Total","17655","101","181","81","18018"
"Weston",1996,"0","62","0","2","0","64"
"Weston",1996,"1","75","0","0","0","75"
"Weston",1996,"2","74","0","4","0","78"
"Weston",1996,"3","76","0","1","0","77"
"Weston",1996,"4","80","0","3","0","83"
"Weston",1996,"5","75","0","0","0","75"
"Weston",1996,"6","87","0","0","0","87"
"Weston",1996,"7","85","0","0","0","85"
"Weston",1996,"8","84","0","0","0","84"
"Weston",1996,"9","97","0","5","0","102"
"Weston",1996,"10","105","0","4","0","109"
"Weston",1996,"11","128","0","2","0","130"
"Weston",1996,"12","112","0","0","0","112"
"Weston",1996,"13","136","0","0","0","136"
"Weston",1996,"14","115","0","0","0","115"
"Weston",1996,"15","134","0","0","0","134"
"Weston",1996,"16","120","0","0","0","120"
"Weston",1996,"17","119","0","3","0","122"
"Weston",1996,"18 to 20","247","0","15","0","262"
"Weston",1996,"21 to 24","229","0","6","0","235"
"Weston",1996,"25 & over","4450","0","29","4","4483"
"Weston",1996,"Total","6690","0","74","4","6768"
"Niobrara",1996,"0","20","0","0","0","20"
"Niobrara",1996,"1","26","0","0","0","26"
"Niobrara",1996,"2","23","0","0","0","23"
"Niobrara",1996,"3","31","0","0","0","31"
"Niobrara",1996,"4","24","0","0","0","24"
"Niobrara",1996,"5","30","0","0","0","30"
"Niobrara",1996,"6","24","0","0","0","24"
"Niobrara",1996,"7","38","0","0","0","38"
"Niobrara",1996,"8","30","0","0","0","30"
"Niobrara",1996,"9","33","0","0","0","33"
"Niobrara",1996,"10","34","0","0","0","34"
"Niobrara",1996,"11","40","0","0","0","40"
"Niobrara",1996,"12","33","0","0","0","33"
"Niobrara",1996,"13","42","0","0","0","42"
"Niobrara",1996,"14","40","0","0","0","40"
"Niobrara",1996,"15","42","0","0","0","42"
"Niobrara",1996,"16","36","0","0","0","36"
"Niobrara",1996,"17","39","0","0","0","39"
"Niobrara",1996,"18 to 20","76","1","0","0","77"
"Niobrara",1996,"21 to 24","66","0","0","0","66"
"Niobrara",1996,"25 & over","1769","1","3","0","1773"
"Niobrara",1996,"Total","2496","2","3","0","2501"
"Washakie",2012,"0","85","2","2","0","89"
"Washakie",2012,"1","107","2","1","0","110"
"Washakie",2012,"2","102","3","0","0","105"
"Washakie",2012,"3","99","3","1","1","104"
"Washakie",2012,"4","100","1","1","2","104"
"Washakie",2012,"5","113","0","3","1","117"
"Washakie",2012,"6","126","3","4","0","133"
"Washakie",2012,"7","125","1","3","1","130"
"Washakie",2012,"8","120","0","1","2","123"
"Washakie",2012,"9","124","1","2","2","129"
"Washakie",2012,"10","122","0","3","0","125"
"Washakie",2012,"11","115","0","2","0","117"
"Washakie",2012,"12","110","2","2","2","116"
"Washakie",2012,"13","115","0","4","2","121"
"Washakie",2012,"14","116","0","6","0","122"
"Washakie",2012,"15","115","1","2","2","120"
"Washakie",2012,"16","115","1","4","0","120"
"Washakie",2012,"17","122","4","5","3","134"
"Washakie",2012,"18 to 20","245","8","8","5","266"
"Washakie",2012,"21 to 24","256","7","4","6","273"
"Washakie",2012,"25 & over","5620","30","87","42","5779"
"Washakie",2012,"Total","8152","69","145","71","8437"
"Platte",2014,"0","80","1","0","1","82"
"Platte",2014,"1","89","2","2","1","94"
"Platte",2014,"2","109","2","2","1","114"
"Platte",2014,"3","98","0","0","1","99"
"Platte",2014,"4","79","2","1","1","83"
"Platte",2014,"5","90","2","1","0","93"
"Platte",2014,"6","95","0","1","1","97"
"Platte",2014,"7","98","1","2","2","103"
"Platte",2014,"8","85","0","1","1","87"
"Platte",2014,"9","96","2","0","0","98"
"Platte",2014,"10","79","1","0","0","80"
"Platte",2014,"11","96","1","2","0","99"
"Platte",2014,"12","113","2","1","0","116"
"Platte",2014,"13","96","1","0","0","97"
"Platte",2014,"14","103","0","2","2","107"
"Platte",2014,"15","107","0","0","0","107"
"Platte",2014,"16","104","3","1","0","108"
"Platte",2014,"17","129","2","0","1","132"
"Platte",2014,"18 to 20","245","3","3","6","257"
"Platte",2014,"21 to 24","330","6","4","4","344"
"Platte",2014,"25 & over","6252","46","47","33","6378"
"Platte",2014,"Total","8573","77","70","55","8775"
"Goshen",2005,"0","133","2","2","0","137"
"Goshen",2005,"1","128","2","3","2","135"
"Goshen",2005,"2","146","4","0","1","151"
"Goshen",2005,"3","164","2","2","0","168"
"Goshen",2005,"4","117","1","1","0","119"
"Goshen",2005,"5","130","0","2","0","132"
"Goshen",2005,"6","133","1","3","2","139"
"Goshen",2005,"7","144","1","3","1","149"
"Goshen",2005,"8","124","2","1","0","127"
"Goshen",2005,"9","126","1","3","0","130"
"Goshen",2005,"10","142","1","0","0","143"
"Goshen",2005,"11","176","1","2","0","179"
"Goshen",2005,"12","138","1","6","1","146"
"Goshen",2005,"13","187","2","2","1","192"
"Goshen",2005,"14","183","1","4","2","190"
"Goshen",2005,"15","179","2","2","0","183"
"Goshen",2005,"16","156","1","2","0","159"
"Goshen",2005,"17","177","1","5","1","184"
"Goshen",2005,"18 to 20","610","6","7","3","626"
"Goshen",2005,"21 to 24","565","8","8","4","585"
"Goshen",2005,"25 & over","8374","31","59","22","8486"
"Goshen",2005,"Total","12232","71","117","40","12460"
"Platte",2013,"0","90","0","3","1","94"
"Platte",2013,"1","102","2","1","0","105"
"Platte",2013,"2","93","1","0","0","94"
"Platte",2013,"3","83","0","1","1","85"
"Platte",2013,"4","84","2","2","0","88"
"Platte",2013,"5","93","1","2","0","96"
"Platte",2013,"6","95","1","1","2","99"
"Platte",2013,"7","82","0","1","1","84"
"Platte",2013,"8","94","1","0","0","95"
"Platte",2013,"9","84","0","0","0","84"
"Platte",2013,"10","91","3","1","0","95"
"Platte",2013,"11","107","1","1","0","109"
"Platte",2013,"12","96","0","0","0","96"
"Platte",2013,"13","90","2","2","2","96"
"Platte",2013,"14","103","0","0","0","103"
"Platte",2013,"15","98","3","1","0","102"
"Platte",2013,"16","113","1","0","1","115"
"Platte",2013,"17","102","0","1","2","105"
"Platte",2013,"18 to 20","273","12","4","6","295"
"Platte",2013,"21 to 24","307","4","5","3","319"
"Platte",2013,"25 & over","6210","58","42","34","6344"
"Platte",2013,"Total","8490","92","68","53","8703"
"Crook",2010,"0","113","0","0","0","113"
"Crook",2010,"1","97","0","0","0","97"
"Crook",2010,"2","113","1","0","1","115"
"Crook",2010,"3","106","2","1","1","110"
"Crook",2010,"4","85","0","1","1","87"
"Crook",2010,"5","92","1","1","0","94"
"Crook",2010,"6","96","1","1","0","98"
"Crook",2010,"7","94","2","0","0","96"
"Crook",2010,"8","89","1","1","1","92"
"Crook",2010,"9","78","2","3","0","83"
"Crook",2010,"10","81","2","1","0","84"
"Crook",2010,"11","80","1","3","0","84"
"Crook",2010,"12","81","1","0","0","82"
"Crook",2010,"13","88","1","1","0","90"
"Crook",2010,"14","94","2","0","0","96"
"Crook",2010,"15","96","0","2","0","98"
"Crook",2010,"16","97","1","1","0","99"
"Crook",2010,"17","100","0","2","0","102"
"Crook",2010,"18 to 20","203","2","1","0","206"
"Crook",2010,"21 to 24","243","0","3","0","246"
"Crook",2010,"25 & over","4890","13","32","8","4943"
"Crook",2010,"Total","7016","33","54","12","7115"
"Park",1996,"0","283","0","2","1","286"
"Park",1996,"1","290","0","4","0","294"
"Park",1996,"2","312","0","4","3","319"
"Park",1996,"3","305","0","0","0","305"
"Park",1996,"4","307","0","1","5","313"
"Park",1996,"5","306","1","3","4","314"
"Park",1996,"6","328","0","0","0","328"
"Park",1996,"7","332","0","3","0","335"
"Park",1996,"8","353","0","2","0","355"
"Park",1996,"9","366","0","1","0","367"
"Park",1996,"10","368","0","4","0","372"
"Park",1996,"11","411","0","0","4","415"
"Park",1996,"12","426","0","7","3","436"
"Park",1996,"13","437","2","2","3","444"
"Park",1996,"14","427","2","0","1","430"
"Park",1996,"15","457","2","1","0","460"
"Park",1996,"16","427","0","6","3","436"
"Park",1996,"17","435","0","1","0","436"
"Park",1996,"18 to 20","1369","0","14","13","1396"
"Park",1996,"21 to 24","1010","0","3","11","1024"
"Park",1996,"25 & over","16306","10","71","62","16449"
"Park",1996,"Total","25255","17","129","113","25514"
"Uinta",2009,"0","370","4","17","2","393"
"Uinta",2009,"1","319","2","2","2","325"
"Uinta",2009,"2","372","2","3","1","378"
"Uinta",2009,"3","371","2","2","0","375"
"Uinta",2009,"4","300","3","3","5","311"
"Uinta",2009,"5","392","2","3","3","400"
"Uinta",2009,"6","363","2","7","0","372"
"Uinta",2009,"7","329","2","2","1","334"
"Uinta",2009,"8","361","9","4","2","376"
"Uinta",2009,"9","307","5","0","2","314"
"Uinta",2009,"10","360","3","4","2","369"
"Uinta",2009,"11","297","4","6","4","311"
"Uinta",2009,"12","368","1","7","1","377"
"Uinta",2009,"13","345","1","3","1","350"
"Uinta",2009,"14","297","2","4","3","306"
"Uinta",2009,"15","319","4","3","1","327"
"Uinta",2009,"16","368","4","10","2","384"
"Uinta",2009,"17","324","4","4","2","334"
"Uinta",2009,"18 to 20","761","8","18","3","790"
"Uinta",2009,"21 to 24","893","1","7","7","908"
"Uinta",2009,"25 & over","12765","38","144","73","13020"
"Uinta",2009,"Total","20581","103","253","117","21054"
"Goshen",2008,"0","133","3","2","0","138"
"Goshen",2008,"1","127","2","1","2","132"
"Goshen",2008,"2","117","5","0","1","123"
"Goshen",2008,"3","151","3","4","0","158"
"Goshen",2008,"4","132","1","2","1","136"
"Goshen",2008,"5","145","1","0","0","146"
"Goshen",2008,"6","132","1","2","4","139"
"Goshen",2008,"7","129","1","3","1","134"
"Goshen",2008,"8","127","2","0","0","129"
"Goshen",2008,"9","128","1","3","1","133"
"Goshen",2008,"10","163","2","1","1","167"
"Goshen",2008,"11","121","0","1","1","123"
"Goshen",2008,"12","142","0","5","1","148"
"Goshen",2008,"13","151","2","3","2","158"
"Goshen",2008,"14","167","1","2","1","171"
"Goshen",2008,"15","128","3","2","0","133"
"Goshen",2008,"16","176","3","2","0","181"
"Goshen",2008,"17","177","2","3","0","182"
"Goshen",2008,"18 to 20","657","13","8","6","684"
"Goshen",2008,"21 to 24","576","8","7","1","592"
"Goshen",2008,"25 & over","8729","41","68","27","8865"
"Goshen",2008,"Total","12508","95","119","50","12772"
"Sweetwater",2011,"0","602","10","10","10","632"
"Sweetwater",2011,"1","641","18","14","7","680"
"Sweetwater",2011,"2","715","20","12","8","755"
"Sweetwater",2011,"3","721","14","12","5","752"
"Sweetwater",2011,"4","696","18","10","6","730"
"Sweetwater",2011,"5","713","16","9","6","744"
"Sweetwater",2011,"6","659","12","14","4","689"
"Sweetwater",2011,"7","642","7","10","9","668"
"Sweetwater",2011,"8","655","14","13","6","688"
"Sweetwater",2011,"9","635","14","9","6","664"
"Sweetwater",2011,"10","610","12","10","6","638"
"Sweetwater",2011,"11","620","12","13","4","649"
"Sweetwater",2011,"12","605","10","8","4","627"
"Sweetwater",2011,"13","598","10","13","4","625"
"Sweetwater",2011,"14","605","12","11","4","632"
"Sweetwater",2011,"15","555","12","10","8","585"
"Sweetwater",2011,"16","541","10","8","3","562"
"Sweetwater",2011,"17","557","9","13","8","587"
"Sweetwater",2011,"18 to 20","1654","36","37","21","1748"
"Sweetwater",2011,"21 to 24","2303","59","38","37","2437"
"Sweetwater",2011,"25 & over","26984","335","328","289","27936"
"Sweetwater",2011,"Total","42311","660","602","455","44028"
"Washakie",1999,"0","93","0","0","1","94"
"Washakie",1999,"1","106","0","3","0","109"
"Washakie",1999,"2","103","0","0","2","105"
"Washakie",1999,"3","96","0","0","0","96"
"Washakie",1999,"4","96","0","0","0","96"
"Washakie",1999,"5","106","2","5","3","116"
"Washakie",1999,"6","95","0","0","1","96"
"Washakie",1999,"7","111","0","0","0","111"
"Washakie",1999,"8","135","0","0","0","135"
"Washakie",1999,"9","137","0","0","0","137"
"Washakie",1999,"10","153","0","0","1","154"
"Washakie",1999,"11","128","0","0","0","128"
"Washakie",1999,"12","141","0","1","3","145"
"Washakie",1999,"13","139","0","1","0","140"
"Washakie",1999,"14","161","0","2","0","163"
"Washakie",1999,"15","163","0","5","0","168"
"Washakie",1999,"16","194","0","0","0","194"
"Washakie",1999,"17","149","0","0","1","150"
"Washakie",1999,"18 to 20","278","0","1","0","279"
"Washakie",1999,"21 to 24","266","0","0","0","266"
"Washakie",1999,"25 & over","5493","2","32","16","5543"
"Washakie",1999,"Total","8343","4","50","28","8425"
"Park",1995,"0","285","0","1","1","287"
"Park",1995,"1","298","0","4","0","302"
"Park",1995,"2","314","0","4","5","323"
"Park",1995,"3","314","0","0","0","314"
"Park",1995,"4","319","0","2","2","323"
"Park",1995,"5","328","2","2","5","337"
"Park",1995,"6","324","0","0","0","324"
"Park",1995,"7","339","0","2","0","341"
"Park",1995,"8","365","0","2","0","367"
"Park",1995,"9","381","0","2","0","383"
"Park",1995,"10","390","0","5","0","395"
"Park",1995,"11","408","0","0","4","412"
"Park",1995,"12","446","0","6","3","455"
"Park",1995,"13","437","1","3","1","442"
"Park",1995,"14","423","1","0","1","425"
"Park",1995,"15","455","1","3","0","459"
"Park",1995,"16","409","0","7","2","418"
"Park",1995,"17","423","0","1","0","424"
"Park",1995,"18 to 20","1408","0","11","16","1435"
"Park",1995,"21 to 24","1027","0","2","13","1042"
"Park",1995,"25 & over","16143","8","65","57","16273"
"Park",1995,"Total","25236","13","122","110","25481"
"Fremont",2012,"0","326","10","262","1","599"
"Fremont",2012,"1","353","13","264","5","635"
"Fremont",2012,"2","382","7","238","7","634"
"Fremont",2012,"3","387","4","221","2","614"
"Fremont",2012,"4","373","6","234","5","618"
"Fremont",2012,"5","408","6","199","3","616"
"Fremont",2012,"6","402","2","247","1","652"
"Fremont",2012,"7","382","3","244","4","633"
"Fremont",2012,"8","360","5","212","5","582"
"Fremont",2012,"9","363","6","215","2","586"
"Fremont",2012,"10","354","4","199","2","559"
"Fremont",2012,"11","360","6","180","4","550"
"Fremont",2012,"12","340","3","167","0","510"
"Fremont",2012,"13","345","6","170","1","522"
"Fremont",2012,"14","350","6","181","2","539"
"Fremont",2012,"15","357","3","166","4","530"
"Fremont",2012,"16","358","5","163","3","529"
"Fremont",2012,"17","347","2","162","2","513"
"Fremont",2012,"18 to 20","1031","18","464","6","1519"
"Fremont",2012,"21 to 24","1392","31","576","12","2011"
"Fremont",2012,"25 & over","22285","230","4518","146","27179"
"Fremont",2012,"Total","31255","376","9282","217","41130"
"Lincoln",1999,"0","194","0","2","0","196"
"Lincoln",1999,"1","200","0","2","2","204"
"Lincoln",1999,"2","198","0","2","1","201"
"Lincoln",1999,"3","185","0","0","1","186"
"Lincoln",1999,"4","192","0","0","1","193"
"Lincoln",1999,"5","204","2","0","0","206"
"Lincoln",1999,"6","233","0","0","1","234"
"Lincoln",1999,"7","235","0","0","0","235"
"Lincoln",1999,"8","247","0","4","0","251"
"Lincoln",1999,"9","285","0","2","0","287"
"Lincoln",1999,"10","221","1","7","3","232"
"Lincoln",1999,"11","283","0","0","0","283"
"Lincoln",1999,"12","277","0","2","0","279"
"Lincoln",1999,"13","307","0","1","0","308"
"Lincoln",1999,"14","292","0","0","0","292"
"Lincoln",1999,"15","311","4","1","0","316"
"Lincoln",1999,"16","312","0","1","0","313"
"Lincoln",1999,"17","331","0","0","0","331"
"Lincoln",1999,"18 to 20","553","2","7","0","562"
"Lincoln",1999,"21 to 24","465","0","0","0","465"
"Lincoln",1999,"25 & over","8711","2","30","21","8764"
"Lincoln",1999,"Total","14236","11","61","30","14338"
"Teton",2011,"0","254","2","2","4","262"
"Teton",2011,"1","266","2","5","2","275"
"Teton",2011,"2","263","3","4","1","271"
"Teton",2011,"3","263","6","3","4","276"
"Teton",2011,"4","257","2","2","4","265"
"Teton",2011,"5","227","2","4","3","236"
"Teton",2011,"6","230","3","5","4","242"
"Teton",2011,"7","223","3","2","4","232"
"Teton",2011,"8","221","2","2","8","233"
"Teton",2011,"9","199","4","3","4","210"
"Teton",2011,"10","189","0","2","4","195"
"Teton",2011,"11","209","0","5","8","222"
"Teton",2011,"12","191","0","3","2","196"
"Teton",2011,"13","199","1","4","6","210"
"Teton",2011,"14","219","2","1","4","226"
"Teton",2011,"15","179","0","2","4","185"
"Teton",2011,"16","207","3","4","7","221"
"Teton",2011,"17","216","0","1","2","219"
"Teton",2011,"18 to 20","441","10","9","3","463"
"Teton",2011,"21 to 24","961","8","12","23","1004"
"Teton",2011,"25 & over","15405","69","158","199","15831"
"Teton",2011,"Total","20819","122","233","300","21474"
"Sheridan",1996,"0","277","0","3","0","280"
"Sheridan",1996,"1","252","1","5","3","261"
"Sheridan",1996,"2","282","0","2","0","284"
"Sheridan",1996,"3","288","0","4","0","292"
"Sheridan",1996,"4","269","0","8","3","280"
"Sheridan",1996,"5","299","2","9","3","313"
"Sheridan",1996,"6","339","0","5","3","347"
"Sheridan",1996,"7","356","0","2","0","358"
"Sheridan",1996,"8","316","0","9","0","325"
"Sheridan",1996,"9","340","0","4","0","344"
"Sheridan",1996,"10","383","0","5","1","389"
"Sheridan",1996,"11","394","0","4","1","399"
"Sheridan",1996,"12","410","5","6","0","421"
"Sheridan",1996,"13","414","2","3","0","419"
"Sheridan",1996,"14","445","0","13","7","465"
"Sheridan",1996,"15","473","1","12","1","487"
"Sheridan",1996,"16","459","0","7","4","470"
"Sheridan",1996,"17","462","0","5","7","474"
"Sheridan",1996,"18 to 20","1021","12","13","0","1046"
"Sheridan",1996,"21 to 24","932","0","19","10","961"
"Sheridan",1996,"25 & over","17166","14","160","53","17393"
"Sheridan",1996,"Total","25577","37","298","96","26008"
"Sublette",2010,"0","128","1","0","0","129"
"Sublette",2010,"1","148","5","2","1","156"
"Sublette",2010,"2","151","3","1","1","156"
"Sublette",2010,"3","140","1","2","0","143"
"Sublette",2010,"4","131","0","2","1","134"
"Sublette",2010,"5","143","2","1","1","147"
"Sublette",2010,"6","133","0","1","1","135"
"Sublette",2010,"7","129","1","1","0","131"
"Sublette",2010,"8","129","0","1","2","132"
"Sublette",2010,"9","123","0","1","2","126"
"Sublette",2010,"10","127","2","1","0","130"
"Sublette",2010,"11","134","1","2","1","138"
"Sublette",2010,"12","124","2","1","1","128"
"Sublette",2010,"13","118","1","2","0","121"
"Sublette",2010,"14","132","0","1","0","133"
"Sublette",2010,"15","118","2","2","3","125"
"Sublette",2010,"16","135","0","5","0","140"
"Sublette",2010,"17","125","2","4","0","131"
"Sublette",2010,"18 to 20","284","2","8","3","297"
"Sublette",2010,"21 to 24","427","5","3","13","448"
"Sublette",2010,"25 & over","6925","39","66","33","7063"
"Sublette",2010,"Total","10004","69","107","63","10243"
"Fremont",2008,"0","321","4","297","1","623"
"Fremont",2008,"1","343","1","260","0","604"
"Fremont",2008,"2","325","4","260","2","591"
"Fremont",2008,"3","351","6","241","2","600"
"Fremont",2008,"4","329","6","207","7","549"
"Fremont",2008,"5","344","3","225","2","574"
"Fremont",2008,"6","347","2","142","6","497"
"Fremont",2008,"7","351","4","182","2","539"
"Fremont",2008,"8","359","4","155","3","521"
"Fremont",2008,"9","336","7","189","1","533"
"Fremont",2008,"10","305","3","200","0","508"
"Fremont",2008,"11","312","3","123","3","441"
"Fremont",2008,"12","335","4","154","3","496"
"Fremont",2008,"13","353","2","172","4","531"
"Fremont",2008,"14","372","4","203","5","584"
"Fremont",2008,"15","342","0","162","3","507"
"Fremont",2008,"16","366","3","172","1","542"
"Fremont",2008,"17","417","1","202","4","624"
"Fremont",2008,"18 to 20","1041","3","472","4","1520"
"Fremont",2008,"21 to 24","1318","11","532","6","1867"
"Fremont",2008,"25 & over","21245","66","4231","114","25656"
"Fremont",2008,"Total","29812","141","8781","173","38907"
"Niobrara",1992,"0","26","0","0","0","26"
"Niobrara",1992,"1","25","0","0","0","25"
"Niobrara",1992,"2","28","0","0","0","28"
"Niobrara",1992,"3","31","0","0","0","31"
"Niobrara",1992,"4","23","0","0","0","23"
"Niobrara",1992,"5","30","0","0","0","30"
"Niobrara",1992,"6","28","0","0","0","28"
"Niobrara",1992,"7","39","0","0","0","39"
"Niobrara",1992,"8","36","0","0","0","36"
"Niobrara",1992,"9","35","0","0","0","35"
"Niobrara",1992,"10","36","0","0","0","36"
"Niobrara",1992,"11","39","0","0","0","39"
"Niobrara",1992,"12","35","0","0","0","35"
"Niobrara",1992,"13","40","0","0","0","40"
"Niobrara",1992,"14","38","0","0","0","38"
"Niobrara",1992,"15","39","0","0","0","39"
"Niobrara",1992,"16","34","0","0","0","34"
"Niobrara",1992,"17","35","0","0","0","35"
"Niobrara",1992,"18 to 20","67","2","0","0","69"
"Niobrara",1992,"21 to 24","60","0","0","0","60"
"Niobrara",1992,"25 & over","1680","2","3","0","1685"
"Niobrara",1992,"Total","2404","4","3","0","2411"
"Park",2013,"0","296","1","2","5","304"
"Park",2013,"1","340","6","4","2","352"
"Park",2013,"2","289","6","4","3","302"
"Park",2013,"3","288","4","3","5","300"
"Park",2013,"4","331","5","2","3","341"
"Park",2013,"5","342","3","2","6","353"
"Park",2013,"6","330","2","5","4","341"
"Park",2013,"7","344","3","7","2","356"
"Park",2013,"8","336","4","2","1","343"
"Park",2013,"9","313","4","4","0","321"
"Park",2013,"10","332","3","4","3","342"
"Park",2013,"11","306","2","5","0","313"
"Park",2013,"12","311","2","4","0","317"
"Park",2013,"13","306","4","5","4","319"
"Park",2013,"14","310","3","3","2","318"
"Park",2013,"15","331","3","5","3","342"
"Park",2013,"16","340","6","9","7","362"
"Park",2013,"17","338","3","5","4","350"
"Park",2013,"18 to 20","1139","51","28","25","1243"
"Park",2013,"21 to 24","1234","67","14","27","1342"
"Park",2013,"25 & over","19929","308","141","157","20535"
"Park",2013,"Total","28085","490","258","263","29096"
"Natrona",2010,"0","967","25","12","13","1017"
"Natrona",2010,"1","977","28","17","11","1033"
"Natrona",2010,"2","1042","34","16","10","1102"
"Natrona",2010,"3","1052","35","20","13","1120"
"Natrona",2010,"4","1024","27","22","10","1083"
"Natrona",2010,"5","971","30","18","11","1030"
"Natrona",2010,"6","968","21","22","12","1023"
"Natrona",2010,"7","966","17","21","15","1019"
"Natrona",2010,"8","912","21","16","9","958"
"Natrona",2010,"9","919","24","15","9","967"
"Natrona",2010,"10","917","20","22","9","968"
"Natrona",2010,"11","887","20","16","15","938"
"Natrona",2010,"12","852","22","15","8","897"
"Natrona",2010,"13","860","26","22","7","915"
"Natrona",2010,"14","918","19","14","11","962"
"Natrona",2010,"15","929","18","12","10","969"
"Natrona",2010,"16","951","18","18","8","995"
"Natrona",2010,"17","957","19","20","7","1003"
"Natrona",2010,"18 to 20","2992","70","57","28","3147"
"Natrona",2010,"21 to 24","3853","74","88","47","4062"
"Natrona",2010,"25 & over","48734","502","599","431","50266"
"Natrona",2010,"Total","72648","1070","1062","694","75474"
"Crook",2013,"0","86","1","0","0","87"
"Crook",2013,"1","103","2","1","0","106"
"Crook",2013,"2","81","1","1","0","83"
"Crook",2013,"3","111","0","1","0","112"
"Crook",2013,"4","84","1","1","0","86"
"Crook",2013,"5","106","2","0","1","109"
"Crook",2013,"6","100","1","2","1","104"
"Crook",2013,"7","92","1","1","1","95"
"Crook",2013,"8","92","1","1","0","94"
"Crook",2013,"9","90","2","1","0","93"
"Crook",2013,"10","91","0","2","0","93"
"Crook",2013,"11","94","2","2","1","99"
"Crook",2013,"12","81","2","3","0","86"
"Crook",2013,"13","86","2","1","0","89"
"Crook",2013,"14","75","1","2","0","78"
"Crook",2013,"15","78","0","0","0","78"
"Crook",2013,"16","89","1","1","0","91"
"Crook",2013,"17","109","2","0","0","111"
"Crook",2013,"18 to 20","207","7","4","0","218"
"Crook",2013,"21 to 24","252","5","1","0","258"
"Crook",2013,"25 & over","4870","68","36","10","4984"
"Crook",2013,"Total","6977","102","61","14","7154"
"Hot Springs",1997,"0","50","0","0","0","50"
"Hot Springs",1997,"1","48","0","1","0","49"
"Hot Springs",1997,"2","40","0","5","0","45"
"Hot Springs",1997,"3","41","0","0","0","41"
"Hot Springs",1997,"4","49","0","2","0","51"
"Hot Springs",1997,"5","41","0","1","0","42"
"Hot Springs",1997,"6","49","0","3","0","52"
"Hot Springs",1997,"7","60","0","1","0","61"
"Hot Springs",1997,"8","55","0","2","0","57"
"Hot Springs",1997,"9","70","0","1","0","71"
"Hot Springs",1997,"10","64","0","1","0","65"
"Hot Springs",1997,"11","69","0","3","0","72"
"Hot Springs",1997,"12","78","0","4","0","82"
"Hot Springs",1997,"13","78","0","1","0","79"
"Hot Springs",1997,"14","95","0","1","0","96"
"Hot Springs",1997,"15","80","0","5","0","85"
"Hot Springs",1997,"16","88","0","3","0","91"
"Hot Springs",1997,"17","83","0","2","0","85"
"Hot Springs",1997,"18 to 20","149","1","2","0","152"
"Hot Springs",1997,"21 to 24","129","0","2","0","131"
"Hot Springs",1997,"25 & over","3517","0","37","0","3554"
"Hot Springs",1997,"Total","4933","1","77","0","5011"
"Goshen",2014,"0","145","4","4","1","154"
"Goshen",2014,"1","129","2","13","0","144"
"Goshen",2014,"2","124","3","3","1","131"
"Goshen",2014,"3","119","4","0","0","123"
"Goshen",2014,"4","151","1","2","1","155"
"Goshen",2014,"5","160","1","4","2","167"
"Goshen",2014,"6","132","6","2","3","143"
"Goshen",2014,"7","173","3","3","0","179"
"Goshen",2014,"8","125","3","1","1","130"
"Goshen",2014,"9","131","0","2","0","133"
"Goshen",2014,"10","156","1","0","2","159"
"Goshen",2014,"11","136","3","4","3","146"
"Goshen",2014,"12","147","0","1","1","149"
"Goshen",2014,"13","155","1","2","1","159"
"Goshen",2014,"14","170","3","2","1","176"
"Goshen",2014,"15","156","4","0","1","161"
"Goshen",2014,"16","168","4","2","1","175"
"Goshen",2014,"17","168","5","3","2","178"
"Goshen",2014,"18 to 20","530","23","7","3","563"
"Goshen",2014,"21 to 24","731","16","17","8","772"
"Goshen",2014,"25 & over","9217","106","80","46","9449"
"Goshen",2014,"Total","13123","193","152","78","13546"
"Fremont",2005,"0","284","7","270","2","563"
"Fremont",2005,"1","282","1","204","0","487"
"Fremont",2005,"2","281","5","239","1","526"
"Fremont",2005,"3","318","5","112","2","437"
"Fremont",2005,"4","314","4","202","4","524"
"Fremont",2005,"5","359","3","128","2","492"
"Fremont",2005,"6","337","2","193","3","535"
"Fremont",2005,"7","316","3","164","0","483"
"Fremont",2005,"8","306","5","144","2","457"
"Fremont",2005,"9","307","4","161","0","472"
"Fremont",2005,"10","304","3","162","0","469"
"Fremont",2005,"11","374","3","178","3","558"
"Fremont",2005,"12","321","4","176","4","505"
"Fremont",2005,"13","395","3","205","4","607"
"Fremont",2005,"14","408","3","208","6","625"
"Fremont",2005,"15","376","1","147","2","526"
"Fremont",2005,"16","385","4","192","5","586"
"Fremont",2005,"17","377","0","159","1","537"
"Fremont",2005,"18 to 20","1135","6","425","8","1574"
"Fremont",2005,"21 to 24","1304","5","500","9","1818"
"Fremont",2005,"25 & over","20115","57","3786","99","24057"
"Fremont",2005,"Total","28598","128","7955","157","36838"
"Campbell",2002,"0","496","3","19","5","523"
"Campbell",2002,"1","519","5","15","6","545"
"Campbell",2002,"2","565","4","10","2","581"
"Campbell",2002,"3","532","7","9","2","550"
"Campbell",2002,"4","572","6","7","4","589"
"Campbell",2002,"5","512","3","9","1","525"
"Campbell",2002,"6","539","6","8","3","556"
"Campbell",2002,"7","519","6","9","3","537"
"Campbell",2002,"8","560","7","12","1","580"
"Campbell",2002,"9","579","5","8","5","597"
"Campbell",2002,"10","579","2","8","2","591"
"Campbell",2002,"11","605","2","11","4","622"
"Campbell",2002,"12","623","4","8","2","637"
"Campbell",2002,"13","597","2","8","2","609"
"Campbell",2002,"14","627","4","13","9","653"
"Campbell",2002,"15","672","2","10","2","686"
"Campbell",2002,"16","670","1","9","3","683"
"Campbell",2002,"17","719","3","11","3","736"
"Campbell",2002,"18 to 20","1574","10","26","8","1618"
"Campbell",2002,"21 to 24","1991","5","41","13","2050"
"Campbell",2002,"25 & over","21328","50","239","108","21725"
"Campbell",2002,"Total","35378","137","490","188","36193"
"Sheridan",2001,"0","263","3","7","1","274"
"Sheridan",2001,"1","312","2","6","3","323"
"Sheridan",2001,"2","236","1","7","0","244"
"Sheridan",2001,"3","279","2","4","0","285"
"Sheridan",2001,"4","296","2","7","1","306"
"Sheridan",2001,"5","253","1","6","3","263"
"Sheridan",2001,"6","280","3","7","1","291"
"Sheridan",2001,"7","324","2","11","2","339"
"Sheridan",2001,"8","358","3","8","2","371"
"Sheridan",2001,"9","296","2","7","2","307"
"Sheridan",2001,"10","333","2","6","2","343"
"Sheridan",2001,"11","348","1","7","1","357"
"Sheridan",2001,"12","371","2","6","1","380"
"Sheridan",2001,"13","389","3","8","1","401"
"Sheridan",2001,"14","384","0","15","7","406"
"Sheridan",2001,"15","426","2","11","4","443"
"Sheridan",2001,"16","474","3","18","7","502"
"Sheridan",2001,"17","452","2","9","5","468"
"Sheridan",2001,"18 to 20","1075","9","24","2","1110"
"Sheridan",2001,"21 to 24","1081","3","26","8","1118"
"Sheridan",2001,"25 & over","17757","28","213","94","18092"
"Sheridan",2001,"Total","25987","76","413","147","26623"
"Teton",1999,"0","188","0","2","2","192"
"Teton",1999,"1","176","2","0","2","180"
"Teton",1999,"2","192","0","1","1","194"
"Teton",1999,"3","192","0","0","2","194"
"Teton",1999,"4","159","0","2","1","162"
"Teton",1999,"5","180","0","3","0","183"
"Teton",1999,"6","175","0","0","0","175"
"Teton",1999,"7","176","4","1","0","181"
"Teton",1999,"8","204","0","0","2","206"
"Teton",1999,"9","202","1","0","0","203"
"Teton",1999,"10","224","1","1","0","226"
"Teton",1999,"11","217","0","0","0","217"
"Teton",1999,"12","199","0","0","0","199"
"Teton",1999,"13","215","0","0","0","215"
"Teton",1999,"14","210","0","1","2","213"
"Teton",1999,"15","202","2","2","1","207"
"Teton",1999,"16","235","0","2","0","237"
"Teton",1999,"17","203","0","0","0","203"
"Teton",1999,"18 to 20","494","1","6","0","501"
"Teton",1999,"21 to 24","1186","3","3","5","1197"
"Teton",1999,"25 & over","12277","7","55","48","12387"
"Teton",1999,"Total","17506","21","79","66","17672"
"Niobrara",2000,"0","14","0","0","0","14"
"Niobrara",2000,"1","21","1","0","0","22"
"Niobrara",2000,"2","22","1","0","0","23"
"Niobrara",2000,"3","34","0","0","0","34"
"Niobrara",2000,"4","22","0","0","0","22"
"Niobrara",2000,"5","20","0","0","0","20"
"Niobrara",2000,"6","22","0","0","0","22"
"Niobrara",2000,"7","36","0","0","0","36"
"Niobrara",2000,"8","29","0","0","0","29"
"Niobrara",2000,"9","33","1","0","0","34"
"Niobrara",2000,"10","34","0","1","0","35"
"Niobrara",2000,"11","35","0","0","0","35"
"Niobrara",2000,"12","32","0","0","0","32"
"Niobrara",2000,"13","36","0","0","0","36"
"Niobrara",2000,"14","34","0","0","0","34"
"Niobrara",2000,"15","40","0","0","0","40"
"Niobrara",2000,"16","34","0","0","1","35"
"Niobrara",2000,"17","39","0","0","0","39"
"Niobrara",2000,"18 to 20","76","1","0","0","77"
"Niobrara",2000,"21 to 24","67","1","0","0","68"
"Niobrara",2000,"25 & over","1695","1","11","2","1709"
"Niobrara",2000,"Total","2375","6","12","3","2396"
"Crook",2011,"0","81","1","1","0","83"
"Crook",2011,"1","114","2","0","0","116"
"Crook",2011,"2","89","0","0","0","89"
"Crook",2011,"3","105","1","0","1","107"
"Crook",2011,"4","106","3","1","1","111"
"Crook",2011,"5","82","0","1","1","84"
"Crook",2011,"6","92","1","1","0","94"
"Crook",2011,"7","90","2","1","0","93"
"Crook",2011,"8","88","2","0","0","90"
"Crook",2011,"9","90","2","1","1","94"
"Crook",2011,"10","79","2","4","0","85"
"Crook",2011,"11","80","2","1","0","83"
"Crook",2011,"12","80","2","2","0","84"
"Crook",2011,"13","79","2","0","0","81"
"Crook",2011,"14","89","1","2","0","92"
"Crook",2011,"15","102","1","1","0","104"
"Crook",2011,"16","93","0","2","0","95"
"Crook",2011,"17","103","0","2","0","105"
"Crook",2011,"18 to 20","221","2","1","0","224"
"Crook",2011,"21 to 24","252","2","1","0","255"
"Crook",2011,"25 & over","4902","23","36","9","4970"
"Crook",2011,"Total","7017","51","58","13","7139"
"Goshen",1993,"0","152","0","1","0","153"
"Goshen",1993,"1","144","1","7","0","152"
"Goshen",1993,"2","149","0","0","0","149"
"Goshen",1993,"3","167","0","0","0","167"
"Goshen",1993,"4","159","0","0","0","159"
"Goshen",1993,"5","157","2","2","0","161"
"Goshen",1993,"6","186","0","8","0","194"
"Goshen",1993,"7","160","0","3","0","163"
"Goshen",1993,"8","192","0","4","0","196"
"Goshen",1993,"9","219","0","2","0","221"
"Goshen",1993,"10","213","7","2","1","223"
"Goshen",1993,"11","198","0","7","0","205"
"Goshen",1993,"12","213","0","2","0","215"
"Goshen",1993,"13","218","0","0","0","218"
"Goshen",1993,"14","210","0","0","0","210"
"Goshen",1993,"15","213","0","5","0","218"
"Goshen",1993,"16","209","0","0","0","209"
"Goshen",1993,"17","187","0","1","0","188"
"Goshen",1993,"18 to 20","569","5","2","3","579"
"Goshen",1993,"21 to 24","507","0","0","1","508"
"Goshen",1993,"25 & over","7958","5","38","5","8006"
"Goshen",1993,"Total","12380","20","84","10","12494"
"Weston",2002,"0","60","0","2","0","62"
"Weston",2002,"1","74","1","3","0","78"
"Weston",2002,"2","56","0","2","0","58"
"Weston",2002,"3","74","0","2","0","76"
"Weston",2002,"4","74","0","2","0","76"
"Weston",2002,"5","73","0","0","0","73"
"Weston",2002,"6","70","0","2","1","73"
"Weston",2002,"7","61","0","0","0","61"
"Weston",2002,"8","70","0","3","1","74"
"Weston",2002,"9","72","0","2","0","74"
"Weston",2002,"10","70","0","1","0","71"
"Weston",2002,"11","74","1","2","1","78"
"Weston",2002,"12","83","1","0","0","84"
"Weston",2002,"13","110","1","1","1","113"
"Weston",2002,"14","94","0","2","0","96"
"Weston",2002,"15","110","0","1","0","111"
"Weston",2002,"16","115","0","1","0","116"
"Weston",2002,"17","123","1","2","0","126"
"Weston",2002,"18 to 20","287","0","12","0","299"
"Weston",2002,"21 to 24","241","3","7","0","251"
"Weston",2002,"25 & over","4469","5","44","10","4528"
"Weston",2002,"Total","6460","13","91","14","6578"
"Big Horn",2000,"0","160","0","0","0","160"
"Big Horn",2000,"1","148","0","1","1","150"
"Big Horn",2000,"2","160","0","1","0","161"
"Big Horn",2000,"3","143","0","1","0","144"
"Big Horn",2000,"4","155","1","1","0","157"
"Big Horn",2000,"5","172","2","1","0","175"
"Big Horn",2000,"6","167","0","2","2","171"
"Big Horn",2000,"7","156","0","0","0","156"
"Big Horn",2000,"8","177","0","2","0","179"
"Big Horn",2000,"9","205","0","2","0","207"
"Big Horn",2000,"10","182","0","4","0","186"
"Big Horn",2000,"11","174","1","2","0","177"
"Big Horn",2000,"12","215","0","5","0","220"
"Big Horn",2000,"13","198","0","3","2","203"
"Big Horn",2000,"14","193","1","3","1","198"
"Big Horn",2000,"15","182","1","2","2","187"
"Big Horn",2000,"16","221","3","2","1","227"
"Big Horn",2000,"17","209","1","2","2","214"
"Big Horn",2000,"18 to 20","427","1","5","1","434"
"Big Horn",2000,"21 to 24","391","1","3","0","395"
"Big Horn",2000,"25 & over","7217","5","54","21","7297"
"Big Horn",2000,"Total","11252","17","96","33","11398"
"Crook",2001,"0","46","0","1","0","47"
"Crook",2001,"1","62","0","2","0","64"
"Crook",2001,"2","55","0","1","0","56"
"Crook",2001,"3","51","0","1","0","52"
"Crook",2001,"4","66","0","2","1","69"
"Crook",2001,"5","55","0","2","0","57"
"Crook",2001,"6","59","0","2","0","61"
"Crook",2001,"7","68","0","0","0","68"
"Crook",2001,"8","80","0","2","1","83"
"Crook",2001,"9","81","0","0","0","81"
"Crook",2001,"10","83","1","0","0","84"
"Crook",2001,"11","81","0","3","0","84"
"Crook",2001,"12","80","0","1","0","81"
"Crook",2001,"13","94","0","0","0","94"
"Crook",2001,"14","116","0","1","0","117"
"Crook",2001,"15","117","0","5","0","122"
"Crook",2001,"16","131","0","1","0","132"
"Crook",2001,"17","114","0","1","0","115"
"Crook",2001,"18 to 20","226","1","3","0","230"
"Crook",2001,"21 to 24","182","0","3","0","185"
"Crook",2001,"25 & over","3858","2","33","3","3896"
"Crook",2001,"Total","5705","4","64","5","5778"
"Sublette",2001,"0","43","1","1","0","45"
"Sublette",2001,"1","66","1","1","0","68"
"Sublette",2001,"2","63","1","0","0","64"
"Sublette",2001,"3","61","1","0","0","62"
"Sublette",2001,"4","68","0","1","1","70"
"Sublette",2001,"5","76","0","0","0","76"
"Sublette",2001,"6","56","0","1","0","57"
"Sublette",2001,"7","92","0","0","0","92"
"Sublette",2001,"8","85","0","1","0","86"
"Sublette",2001,"9","87","1","1","0","89"
"Sublette",2001,"10","81","0","2","0","83"
"Sublette",2001,"11","88","1","2","1","92"
"Sublette",2001,"12","111","0","2","0","113"
"Sublette",2001,"13","86","1","0","0","87"
"Sublette",2001,"14","97","0","0","0","97"
"Sublette",2001,"15","99","0","0","2","101"
"Sublette",2001,"16","79","0","0","0","79"
"Sublette",2001,"17","102","0","0","0","102"
"Sublette",2001,"18 to 20","185","1","0","0","186"
"Sublette",2001,"21 to 24","195","0","2","2","199"
"Sublette",2001,"25 & over","4129","15","21","13","4178"
"Sublette",2001,"Total","5949","23","35","19","6026"
"Weston",1992,"0","70","0","2","0","72"
"Weston",1992,"1","81","0","0","0","81"
"Weston",1992,"2","88","0","3","0","91"
"Weston",1992,"3","85","0","1","0","86"
"Weston",1992,"4","86","0","2","0","88"
"Weston",1992,"5","93","0","0","0","93"
"Weston",1992,"6","101","0","0","0","101"
"Weston",1992,"7","115","0","0","0","115"
"Weston",1992,"8","110","0","0","0","110"
"Weston",1992,"9","124","0","5","0","129"
"Weston",1992,"10","122","0","4","0","126"
"Weston",1992,"11","135","0","1","0","136"
"Weston",1992,"12","123","0","0","0","123"
"Weston",1992,"13","132","0","0","0","132"
"Weston",1992,"14","108","0","0","0","108"
"Weston",1992,"15","127","0","0","0","127"
"Weston",1992,"16","95","0","0","0","95"
"Weston",1992,"17","97","0","3","0","100"
"Weston",1992,"18 to 20","205","0","13","0","218"
"Weston",1992,"21 to 24","217","0","6","0","223"
"Weston",1992,"25 & over","4255","0","25","4","4284"
"Weston",1992,"Total","6569","0","65","4","6638"
"Fremont",2003,"0","245","3","242","2","492"
"Fremont",2003,"1","296","1","154","0","451"
"Fremont",2003,"2","271","4","188","1","464"
"Fremont",2003,"3","340","2","160","1","503"
"Fremont",2003,"4","316","2","199","2","519"
"Fremont",2003,"5","316","3","149","0","468"
"Fremont",2003,"6","288","2","119","3","412"
"Fremont",2003,"7","309","2","169","1","481"
"Fremont",2003,"8","317","4","159","2","482"
"Fremont",2003,"9","372","3","173","1","549"
"Fremont",2003,"10","313","1","169","1","484"
"Fremont",2003,"11","372","2","179","2","555"
"Fremont",2003,"12","392","4","203","3","602"
"Fremont",2003,"13","373","2","155","2","532"
"Fremont",2003,"14","387","1","203","4","595"
"Fremont",2003,"15","369","1","159","1","530"
"Fremont",2003,"16","448","2","160","2","612"
"Fremont",2003,"17","463","1","178","1","643"
"Fremont",2003,"18 to 20","1124","6","404","4","1538"
"Fremont",2003,"21 to 24","1253","4","490","12","1759"
"Fremont",2003,"25 & over","19708","48","3607","96","23459"
"Fremont",2003,"Total","28272","98","7619","141","36130"
"Lincoln",2000,"0","205","0","3","0","208"
"Lincoln",2000,"1","200","0","1","2","203"
"Lincoln",2000,"2","188","1","4","1","194"
"Lincoln",2000,"3","184","0","0","3","187"
"Lincoln",2000,"4","192","0","2","0","194"
"Lincoln",2000,"5","200","1","2","0","203"
"Lincoln",2000,"6","233","0","2","1","236"
"Lincoln",2000,"7","232","0","1","0","233"
"Lincoln",2000,"8","240","1","2","0","243"
"Lincoln",2000,"9","274","1","0","0","275"
"Lincoln",2000,"10","226","2","4","0","232"
"Lincoln",2000,"11","284","2","4","0","290"
"Lincoln",2000,"12","272","4","1","1","278"
"Lincoln",2000,"13","298","0","1","0","299"
"Lincoln",2000,"14","282","1","0","2","285"
"Lincoln",2000,"15","313","0","0","0","313"
"Lincoln",2000,"16","299","0","1","2","302"
"Lincoln",2000,"17","333","3","1","0","337"
"Lincoln",2000,"18 to 20","561","2","5","3","571"
"Lincoln",2000,"21 to 24","478","1","2","0","481"
"Lincoln",2000,"25 & over","8959","10","57","31","9057"
"Lincoln",2000,"Total","14453","29","93","46","14621"
"Sublette",2003,"0","81","1","0","0","82"
"Sublette",2003,"1","70","1","1","0","72"
"Sublette",2003,"2","57","1","0","0","58"
"Sublette",2003,"3","68","1","1","0","70"
"Sublette",2003,"4","72","0","2","1","75"
"Sublette",2003,"5","83","0","0","0","83"
"Sublette",2003,"6","82","0","1","1","84"
"Sublette",2003,"7","89","0","0","0","89"
"Sublette",2003,"8","69","0","1","1","71"
"Sublette",2003,"9","102","1","1","0","104"
"Sublette",2003,"10","84","0","2","0","86"
"Sublette",2003,"11","87","1","1","2","91"
"Sublette",2003,"12","82","0","1","0","83"
"Sublette",2003,"13","95","1","1","0","97"
"Sublette",2003,"14","119","0","0","0","119"
"Sublette",2003,"15","90","1","1","1","93"
"Sublette",2003,"16","97","0","1","0","98"
"Sublette",2003,"17","108","0","1","0","109"
"Sublette",2003,"18 to 20","222","2","1","1","226"
"Sublette",2003,"21 to 24","239","0","3","4","246"
"Sublette",2003,"25 & over","4583","18","31","19","4651"
"Sublette",2003,"Total","6579","28","50","30","6687"
"Goshen",1992,"0","156","0","1","0","157"
"Goshen",1992,"1","147","1","7","0","155"
"Goshen",1992,"2","158","0","0","0","158"
"Goshen",1992,"3","163","0","0","0","163"
"Goshen",1992,"4","161","0","0","0","161"
"Goshen",1992,"5","166","2","2","0","170"
"Goshen",1992,"6","193","0","9","0","202"
"Goshen",1992,"7","167","0","3","0","170"
"Goshen",1992,"8","187","0","3","0","190"
"Goshen",1992,"9","229","0","2","0","231"
"Goshen",1992,"10","212","3","1","1","217"
"Goshen",1992,"11","193","1","6","0","200"
"Goshen",1992,"12","214","1","2","0","217"
"Goshen",1992,"13","207","1","0","0","208"
"Goshen",1992,"14","208","1","0","0","209"
"Goshen",1992,"15","212","0","5","0","217"
"Goshen",1992,"16","197","0","0","0","197"
"Goshen",1992,"17","191","0","1","0","192"
"Goshen",1992,"18 to 20","540","5","2","4","551"
"Goshen",1992,"21 to 24","489","0","0","1","490"
"Goshen",1992,"25 & over","7895","4","37","3","7939"
"Goshen",1992,"Total","12285","19","81","9","12394"
"Niobrara",1993,"0","25","0","0","0","25"
"Niobrara",1993,"1","25","0","0","0","25"
"Niobrara",1993,"2","28","0","0","0","28"
"Niobrara",1993,"3","30","0","0","0","30"
"Niobrara",1993,"4","23","0","0","0","23"
"Niobrara",1993,"5","31","0","0","0","31"
"Niobrara",1993,"6","25","0","0","0","25"
"Niobrara",1993,"7","39","0","0","0","39"
"Niobrara",1993,"8","35","0","0","0","35"
"Niobrara",1993,"9","32","0","0","0","32"
"Niobrara",1993,"10","36","0","0","0","36"
"Niobrara",1993,"11","40","0","0","0","40"
"Niobrara",1993,"12","35","0","0","0","35"
"Niobrara",1993,"13","41","0","0","0","41"
"Niobrara",1993,"14","40","0","0","0","40"
"Niobrara",1993,"15","38","0","0","0","38"
"Niobrara",1993,"16","36","0","0","0","36"
"Niobrara",1993,"17","36","0","0","0","36"
"Niobrara",1993,"18 to 20","70","2","0","0","72"
"Niobrara",1993,"21 to 24","63","0","0","0","63"
"Niobrara",1993,"25 & over","1712","2","3","0","1717"
"Niobrara",1993,"Total","2440","4","3","0","2447"
"Fremont",2004,"0","255","8","227","2","492"
"Fremont",2004,"1","257","1","235","0","493"
"Fremont",2004,"2","298","5","143","1","447"
"Fremont",2004,"3","304","9","196","1","510"
"Fremont",2004,"4","344","3","144","3","494"
"Fremont",2004,"5","329","4","186","0","519"
"Fremont",2004,"6","301","3","158","3","465"
"Fremont",2004,"7","306","3","130","2","441"
"Fremont",2004,"8","310","3","171","1","485"
"Fremont",2004,"9","316","5","159","1","481"
"Fremont",2004,"10","349","2","182","1","534"
"Fremont",2004,"11","325","3","164","2","494"
"Fremont",2004,"12","376","6","176","3","561"
"Fremont",2004,"13","415","3","218","4","640"
"Fremont",2004,"14","380","1","147","2","530"
"Fremont",2004,"15","397","1","197","2","597"
"Fremont",2004,"16","356","2","162","3","523"
"Fremont",2004,"17","457","1","179","1","638"
"Fremont",2004,"18 to 20","1128","7","414","7","1556"
"Fremont",2004,"21 to 24","1315","7","513","11","1846"
"Fremont",2004,"25 & over","19812","48","3672","105","23637"
"Fremont",2004,"Total","28330","125","7773","155","36383"
"Albany",2000,"0","316","11","5","9","341"
"Albany",2000,"1","293","8","3","11","315"
"Albany",2000,"2","305","15","4","5","329"
"Albany",2000,"3","297","8","4","5","314"
"Albany",2000,"4","288","10","6","10","314"
"Albany",2000,"5","308","10","3","3","324"
"Albany",2000,"6","261","6","8","6","281"
"Albany",2000,"7","308","9","6","5","328"
"Albany",2000,"8","285","7","3","3","298"
"Albany",2000,"9","306","5","5","8","324"
"Albany",2000,"10","308","8","9","6","331"
"Albany",2000,"11","279","9","5","7","300"
"Albany",2000,"12","287","6","7","9","309"
"Albany",2000,"13","314","7","5","6","332"
"Albany",2000,"14","316","7","6","3","332"
"Albany",2000,"15","337","6","6","3","352"
"Albany",2000,"16","334","3","10","2","349"
"Albany",2000,"17","363","4","2","4","373"
"Albany",2000,"18 to 20","4024","67","46","54","4191"
"Albany",2000,"21 to 24","4648","102","63","103","4916"
"Albany",2000,"25 & over","16303","148","192","370","17013"
"Albany",2000,"Total","30480","456","398","632","31966"
"Sublette",2002,"0","77","1","1","0","79"
"Sublette",2002,"1","51","1","1","0","53"
"Sublette",2002,"2","66","1","0","0","67"
"Sublette",2002,"3","71","1","1","0","73"
"Sublette",2002,"4","72","0","2","1","75"
"Sublette",2002,"5","82","0","0","0","82"
"Sublette",2002,"6","76","0","1","0","77"
"Sublette",2002,"7","61","0","0","0","61"
"Sublette",2002,"8","97","0","1","0","98"
"Sublette",2002,"9","87","1","1","0","89"
"Sublette",2002,"10","90","0","2","0","92"
"Sublette",2002,"11","82","1","2","2","87"
"Sublette",2002,"12","94","0","1","0","95"
"Sublette",2002,"13","112","1","1","0","114"
"Sublette",2002,"14","95","0","0","0","95"
"Sublette",2002,"15","93","0","0","1","94"
"Sublette",2002,"16","102","0","0","0","102"
"Sublette",2002,"17","83","0","0","0","83"
"Sublette",2002,"18 to 20","209","1","1","1","212"
"Sublette",2002,"21 to 24","207","0","2","4","213"
"Sublette",2002,"25 & over","4392","14","24","18","4448"
"Sublette",2002,"Total","6299","22","41","27","6389"
"Campbell",2010,"0","802","7","18","2","829"
"Campbell",2010,"1","784","6","18","4","812"
"Campbell",2010,"2","805","6","16","2","829"
"Campbell",2010,"3","788","6","21","5","820"
"Campbell",2010,"4","766","6","16","3","791"
"Campbell",2010,"5","746","4","15","1","766"
"Campbell",2010,"6","723","8","19","4","754"
"Campbell",2010,"7","661","3","18","7","689"
"Campbell",2010,"8","648","9","15","2","674"
"Campbell",2010,"9","660","9","12","4","685"
"Campbell",2010,"10","672","6","13","6","697"
"Campbell",2010,"11","683","4","13","8","708"
"Campbell",2010,"12","693","10","9","4","716"
"Campbell",2010,"13","633","9","13","2","657"
"Campbell",2010,"14","623","7","13","6","649"
"Campbell",2010,"15","629","4","10","2","645"
"Campbell",2010,"16","638","7","14","5","664"
"Campbell",2010,"17","624","8","16","5","653"
"Campbell",2010,"18 to 20","1673","31","46","16","1766"
"Campbell",2010,"21 to 24","2616","17","40","22","2695"
"Campbell",2010,"25 & over","28044","126","383","194","28747"
"Campbell",2010,"Total","44911","293","738","304","46246"
"Crook",2008,"0","114","1","0","0","115"
"Crook",2008,"1","109","0","0","0","109"
"Crook",2008,"2","83","2","0","1","86"
"Crook",2008,"3","84","1","1","1","87"
"Crook",2008,"4","75","0","1","1","77"
"Crook",2008,"5","74","2","0","0","76"
"Crook",2008,"6","87","1","2","0","90"
"Crook",2008,"7","87","2","0","0","89"
"Crook",2008,"8","83","1","1","0","85"
"Crook",2008,"9","71","1","2","0","74"
"Crook",2008,"10","69","1","0","0","70"
"Crook",2008,"11","74","1","2","0","77"
"Crook",2008,"12","109","0","0","0","109"
"Crook",2008,"13","71","0","1","0","72"
"Crook",2008,"14","93","0","0","0","93"
"Crook",2008,"15","112","0","2","0","114"
"Crook",2008,"16","94","1","0","0","95"
"Crook",2008,"17","112","0","2","0","114"
"Crook",2008,"18 to 20","198","1","1","0","200"
"Crook",2008,"21 to 24","258","0","3","0","261"
"Crook",2008,"25 & over","4684","8","31","7","4730"
"Crook",2008,"Total","6741","23","49","10","6823"
"Uinta",1992,"0","338","1","1","0","340"
"Uinta",1992,"1","375","3","2","1","381"
"Uinta",1992,"2","355","0","2","0","357"
"Uinta",1992,"3","344","0","0","4","348"
"Uinta",1992,"4","364","2","2","4","372"
"Uinta",1992,"5","386","3","2","2","393"
"Uinta",1992,"6","447","2","1","3","453"
"Uinta",1992,"7","430","0","6","4","440"
"Uinta",1992,"8","427","2","1","0","430"
"Uinta",1992,"9","457","0","2","3","462"
"Uinta",1992,"10","483","1","5","5","494"
"Uinta",1992,"11","466","0","5","0","471"
"Uinta",1992,"12","479","0","5","0","484"
"Uinta",1992,"13","465","0","5","2","472"
"Uinta",1992,"14","455","0","3","0","458"
"Uinta",1992,"15","428","1","6","0","435"
"Uinta",1992,"16","415","0","3","2","420"
"Uinta",1992,"17","380","0","3","1","384"
"Uinta",1992,"18 to 20","696","0","3","6","705"
"Uinta",1992,"21 to 24","741","0","10","0","751"
"Uinta",1992,"25 & over","10331","7","60","28","10426"
"Uinta",1992,"Total","19262","22","127","65","19476"
"Natrona",2009,"0","1017","17","15","10","1059"
"Natrona",2009,"1","955","32","17","12","1016"
"Natrona",2009,"2","1115","32","18","15","1180"
"Natrona",2009,"3","1029","49","11","9","1098"
"Natrona",2009,"4","983","22","24","27","1056"
"Natrona",2009,"5","938","46","16","10","1010"
"Natrona",2009,"6","1012","25","16","12","1065"
"Natrona",2009,"7","915","22","24","16","977"
"Natrona",2009,"8","915","29","23","3","970"
"Natrona",2009,"9","860","21","11","8","900"
"Natrona",2009,"10","978","21","22","12","1033"
"Natrona",2009,"11","844","31","13","10","898"
"Natrona",2009,"12","894","30","19","6","949"
"Natrona",2009,"13","890","29","25","6","950"
"Natrona",2009,"14","966","19","11","14","1010"
"Natrona",2009,"15","943","16","14","9","982"
"Natrona",2009,"16","960","19","24","8","1011"
"Natrona",2009,"17","1013","14","19","9","1055"
"Natrona",2009,"18 to 20","3028","62","55","32","3177"
"Natrona",2009,"21 to 24","4015","81","98","47","4241"
"Natrona",2009,"25 & over","48084","530","578","409","49601"
"Natrona",2009,"Total","72354","1147","1053","684","75238"
"Sweetwater",2016,"0","543","14","15","13","585"
"Sweetwater",2016,"1","604","20","5","7","636"
"Sweetwater",2016,"2","586","16","26","7","635"
"Sweetwater",2016,"3","647","15","8","9","679"
"Sweetwater",2016,"4","539","17","13","3","572"
"Sweetwater",2016,"5","616","10","11","7","644"
"Sweetwater",2016,"6","637","19","16","6","678"
"Sweetwater",2016,"7","695","17","14","6","732"
"Sweetwater",2016,"8","682","18","13","9","722"
"Sweetwater",2016,"9","677","13","15","3","708"
"Sweetwater",2016,"10","711","12","12","2","737"
"Sweetwater",2016,"11","632","14","16","4","666"
"Sweetwater",2016,"12","638","13","10","10","671"
"Sweetwater",2016,"13","636","12","13","10","671"
"Sweetwater",2016,"14","617","15","13","4","649"
"Sweetwater",2016,"15","596","13","7","9","625"
"Sweetwater",2016,"16","611","10","11","7","639"
"Sweetwater",2016,"17","590","13","11","3","617"
"Sweetwater",2016,"18 to 20","1573","32","39","24","1668"
"Sweetwater",2016,"21 to 24","1996","58","40","27","2121"
"Sweetwater",2016,"25 & over","27347","428","445","290","28510"
"Sweetwater",2016,"Total","42173","779","753","460","44165"
"Big Horn",2004,"0","141","0","3","0","144"
"Big Horn",2004,"1","148","0","1","1","150"
"Big Horn",2004,"2","136","1","0","0","137"
"Big Horn",2004,"3","141","0","2","0","143"
"Big Horn",2004,"4","169","1","1","0","171"
"Big Horn",2004,"5","154","2","1","0","157"
"Big Horn",2004,"6","157","0","2","1","160"
"Big Horn",2004,"7","144","0","0","1","145"
"Big Horn",2004,"8","163","0","1","0","164"
"Big Horn",2004,"9","161","0","1","0","162"
"Big Horn",2004,"10","168","0","5","0","173"
"Big Horn",2004,"11","169","2","2","0","173"
"Big Horn",2004,"12","190","0","3","1","194"
"Big Horn",2004,"13","200","0","3","2","205"
"Big Horn",2004,"14","198","1","4","0","203"
"Big Horn",2004,"15","178","1","2","1","182"
"Big Horn",2004,"16","195","1","1","1","198"
"Big Horn",2004,"17","195","1","2","1","199"
"Big Horn",2004,"18 to 20","377","2","7","1","387"
"Big Horn",2004,"21 to 24","445","3","5","0","453"
"Big Horn",2004,"25 & over","7230","12","65","24","7331"
"Big Horn",2004,"Total","11059","27","111","34","11231"
"Natrona",2011,"0","943","36","39","14","1032"
"Natrona",2011,"1","975","27","16","6","1024"
"Natrona",2011,"2","996","27","18","11","1052"
"Natrona",2011,"3","1048","34","19","12","1113"
"Natrona",2011,"4","1047","29","19","13","1108"
"Natrona",2011,"5","1036","29","26","7","1098"
"Natrona",2011,"6","970","26","15","9","1020"
"Natrona",2011,"7","967","18","26","14","1025"
"Natrona",2011,"8","973","21","20","13","1027"
"Natrona",2011,"9","909","15","19","8","951"
"Natrona",2011,"10","914","27","20","8","969"
"Natrona",2011,"11","923","16","18","10","967"
"Natrona",2011,"12","901","22","19","16","958"
"Natrona",2011,"13","866","24","17","8","915"
"Natrona",2011,"14","871","25","23","8","927"
"Natrona",2011,"15","928","23","18","11","980"
"Natrona",2011,"16","930","19","13","8","970"
"Natrona",2011,"17","933","19","19","11","982"
"Natrona",2011,"18 to 20","2837","68","60","30","2995"
"Natrona",2011,"21 to 24","4043","87","87","43","4260"
"Natrona",2011,"25 & over","49377","571","600","489","51037"
"Natrona",2011,"Total","73387","1163","1111","749","76410"
"Teton",1992,"0","184","0","2","2","188"
"Teton",1992,"1","185","2","0","2","189"
"Teton",1992,"2","178","0","3","0","181"
"Teton",1992,"3","179","0","0","1","180"
"Teton",1992,"4","170","0","3","0","173"
"Teton",1992,"5","163","0","2","0","165"
"Teton",1992,"6","156","0","0","0","156"
"Teton",1992,"7","169","2","2","0","173"
"Teton",1992,"8","166","0","0","3","169"
"Teton",1992,"9","176","1","0","0","177"
"Teton",1992,"10","179","1","3","0","183"
"Teton",1992,"11","160","0","0","0","160"
"Teton",1992,"12","163","0","0","0","163"
"Teton",1992,"13","171","0","0","0","171"
"Teton",1992,"14","156","0","4","2","162"
"Teton",1992,"15","136","2","3","2","143"
"Teton",1992,"16","142","0","2","0","144"
"Teton",1992,"17","138","0","0","0","138"
"Teton",1992,"18 to 20","349","2","6","0","357"
"Teton",1992,"21 to 24","681","2","6","9","698"
"Teton",1992,"25 & over","8620","8","56","34","8718"
"Teton",1992,"Total","12621","20","92","55","12788"
"Park",2007,"0","315","4","4","2","325"
"Park",2007,"1","336","3","3","0","342"
"Park",2007,"2","285","1","3","2","291"
"Park",2007,"3","278","2","2","2","284"
"Park",2007,"4","320","0","3","2","325"
"Park",2007,"5","302","1","2","2","307"
"Park",2007,"6","282","4","3","1","290"
"Park",2007,"7","272","2","3","3","280"
"Park",2007,"8","267","1","4","0","272"
"Park",2007,"9","350","4","2","2","358"
"Park",2007,"10","313","2","5","3","323"
"Park",2007,"11","317","2","5","1","325"
"Park",2007,"12","305","4","9","7","325"
"Park",2007,"13","304","6","3","3","316"
"Park",2007,"14","332","2","1","6","341"
"Park",2007,"15","387","1","3","2","393"
"Park",2007,"16","371","1","5","1","378"
"Park",2007,"17","356","5","2","0","363"
"Park",2007,"18 to 20","1235","15","17","23","1290"
"Park",2007,"21 to 24","1198","7","7","18","1230"
"Park",2007,"25 & over","18603","36","112","100","18851"
"Park",2007,"Total","26728","103","198","180","27209"
"Hot Springs",2014,"0","49","0","3","0","52"
"Hot Springs",2014,"1","50","0","1","0","51"
"Hot Springs",2014,"2","57","1","1","0","59"
"Hot Springs",2014,"3","44","0","0","0","44"
"Hot Springs",2014,"4","47","2","0","1","50"
"Hot Springs",2014,"5","46","0","0","0","46"
"Hot Springs",2014,"6","54","0","0","0","54"
"Hot Springs",2014,"7","70","2","1","0","73"
"Hot Springs",2014,"8","49","0","1","0","50"
"Hot Springs",2014,"9","64","1","2","0","67"
"Hot Springs",2014,"10","51","1","1","0","53"
"Hot Springs",2014,"11","63","1","0","1","65"
"Hot Springs",2014,"12","55","0","1","0","56"
"Hot Springs",2014,"13","50","0","1","1","52"
"Hot Springs",2014,"14","62","1","0","0","63"
"Hot Springs",2014,"15","57","1","0","0","58"
"Hot Springs",2014,"16","47","1","0","1","49"
"Hot Springs",2014,"17","59","0","3","1","63"
"Hot Springs",2014,"18 to 20","114","3","4","2","123"
"Hot Springs",2014,"21 to 24","141","4","5","3","153"
"Hot Springs",2014,"25 & over","3420","27","47","22","3516"
"Hot Springs",2014,"Total","4649","45","71","32","4797"
"Washakie",1991,"0","107","0","0","1","108"
"Washakie",1991,"1","107","0","2","0","109"
"Washakie",1991,"2","114","0","0","2","116"
"Washakie",1991,"3","105","0","0","0","105"
"Washakie",1991,"4","115","0","0","0","115"
"Washakie",1991,"5","122","0","3","2","127"
"Washakie",1991,"6","129","0","0","1","130"
"Washakie",1991,"7","133","0","0","0","133"
"Washakie",1991,"8","152","0","0","0","152"
"Washakie",1991,"9","170","0","0","0","170"
"Washakie",1991,"10","160","0","0","1","161"
"Washakie",1991,"11","176","0","0","0","176"
"Washakie",1991,"12","135","0","3","1","139"
"Washakie",1991,"13","154","0","2","0","156"
"Washakie",1991,"14","153","0","1","0","154"
"Washakie",1991,"15","166","0","4","0","170"
"Washakie",1991,"16","140","0","0","0","140"
"Washakie",1991,"17","133","0","0","2","135"
"Washakie",1991,"18 to 20","251","1","1","0","253"
"Washakie",1991,"21 to 24","260","0","0","0","260"
"Washakie",1991,"25 & over","5246","1","18","17","5282"
"Washakie",1991,"Total","8228","2","34","27","8291"
"Uinta",1997,"0","325","0","2","0","327"
"Uinta",1997,"1","345","1","5","3","354"
"Uinta",1997,"2","322","0","1","0","323"
"Uinta",1997,"3","317","0","0","3","320"
"Uinta",1997,"4","356","2","2","3","363"
"Uinta",1997,"5","328","6","3","2","339"
"Uinta",1997,"6","376","2","2","2","382"
"Uinta",1997,"7","357","0","6","3","366"
"Uinta",1997,"8","354","2","1","0","357"
"Uinta",1997,"9","366","0","3","4","373"
"Uinta",1997,"10","417","1","6","5","429"
"Uinta",1997,"11","402","1","4","0","407"
"Uinta",1997,"12","458","1","6","0","465"
"Uinta",1997,"13","442","1","3","3","449"
"Uinta",1997,"14","464","1","5","0","470"
"Uinta",1997,"15","452","2","4","0","458"
"Uinta",1997,"16","484","0","7","4","495"
"Uinta",1997,"17","456","0","2","1","459"
"Uinta",1997,"18 to 20","838","0","4","5","847"
"Uinta",1997,"21 to 24","837","0","10","0","847"
"Uinta",1997,"25 & over","10995","6","71","33","11105"
"Uinta",1997,"Total","19691","26","147","71","19935"
"Goshen",2002,"0","136","1","4","1","142"
"Goshen",2002,"1","132","2","3","1","138"
"Goshen",2002,"2","147","2","1","0","150"
"Goshen",2002,"3","139","0","2","0","141"
"Goshen",2002,"4","148","0","0","1","149"
"Goshen",2002,"5","129","0","2","0","131"
"Goshen",2002,"6","141","1","4","0","146"
"Goshen",2002,"7","123","0","2","0","125"
"Goshen",2002,"8","167","0","2","1","170"
"Goshen",2002,"9","127","0","2","0","129"
"Goshen",2002,"10","174","3","0","1","178"
"Goshen",2002,"11","178","1","3","0","182"
"Goshen",2002,"12","191","0","4","3","198"
"Goshen",2002,"13","163","1","3","0","167"
"Goshen",2002,"14","183","0","4","5","192"
"Goshen",2002,"15","176","1","2","0","179"
"Goshen",2002,"16","182","1","4","0","187"
"Goshen",2002,"17","188","1","3","2","194"
"Goshen",2002,"18 to 20","616","5","7","5","633"
"Goshen",2002,"21 to 24","535","2","5","5","547"
"Goshen",2002,"25 & over","8204","19","62","18","8303"
"Goshen",2002,"Total","12179","40","119","43","12381"
"Uinta",2003,"0","314","2","8","0","324"
"Uinta",2003,"1","295","2","4","1","302"
"Uinta",2003,"2","291","2","3","1","297"
"Uinta",2003,"3","300","0","1","1","302"
"Uinta",2003,"4","294","4","2","7","307"
"Uinta",2003,"5","312","2","4","1","319"
"Uinta",2003,"6","313","2","3","2","320"
"Uinta",2003,"7","331","4","4","2","341"
"Uinta",2003,"8","304","3","4","1","312"
"Uinta",2003,"9","302","2","2","2","308"
"Uinta",2003,"10","302","3","3","2","310"
"Uinta",2003,"11","305","2","2","5","314"
"Uinta",2003,"12","356","1","6","1","364"
"Uinta",2003,"13","361","0","3","0","364"
"Uinta",2003,"14","361","1","6","2","370"
"Uinta",2003,"15","378","4","10","0","392"
"Uinta",2003,"16","376","2","4","2","384"
"Uinta",2003,"17","411","2","4","3","420"
"Uinta",2003,"18 to 20","878","4","18","2","902"
"Uinta",2003,"21 to 24","909","0","7","3","919"
"Uinta",2003,"25 & over","11418","19","121","51","11609"
"Uinta",2003,"Total","19111","61","219","89","19480"
"Uinta",2014,"0","303","7","10","4","324"
"Uinta",2014,"1","297","6","5","5","313"
"Uinta",2014,"2","320","7","5","1","333"
"Uinta",2014,"3","303","11","9","4","327"
"Uinta",2014,"4","332","6","7","3","348"
"Uinta",2014,"5","342","5","6","4","357"
"Uinta",2014,"6","360","5","5","1","371"
"Uinta",2014,"7","333","2","4","1","340"
"Uinta",2014,"8","361","5","1","6","373"
"Uinta",2014,"9","327","4","8","2","341"
"Uinta",2014,"10","367","3","8","2","380"
"Uinta",2014,"11","328","3","5","2","338"
"Uinta",2014,"12","361","4","4","3","372"
"Uinta",2014,"13","328","6","4","0","338"
"Uinta",2014,"14","340","3","4","0","347"
"Uinta",2014,"15","311","4","3","3","321"
"Uinta",2014,"16","335","3","7","2","347"
"Uinta",2014,"17","322","4","3","2","331"
"Uinta",2014,"18 to 20","688","20","15","6","729"
"Uinta",2014,"21 to 24","838","17","23","6","884"
"Uinta",2014,"25 & over","12705","107","162","83","13057"
"Uinta",2014,"Total","20201","232","298","140","20871"
"Sheridan",2014,"0","334","6","13","9","362"
"Sheridan",2014,"1","290","6","5","9","310"
"Sheridan",2014,"2","308","5","6","2","321"
"Sheridan",2014,"3","346","5","9","12","372"
"Sheridan",2014,"4","354","6","7","2","369"
"Sheridan",2014,"5","334","3","6","0","343"
"Sheridan",2014,"6","377","5","11","3","396"
"Sheridan",2014,"7","381","5","7","2","395"
"Sheridan",2014,"8","356","4","3","3","366"
"Sheridan",2014,"9","327","5","6","3","341"
"Sheridan",2014,"10","348","8","6","3","365"
"Sheridan",2014,"11","351","12","6","3","372"
"Sheridan",2014,"12","322","10","3","1","336"
"Sheridan",2014,"13","327","5","8","2","342"
"Sheridan",2014,"14","379","6","9","2","396"
"Sheridan",2014,"15","351","5","6","2","364"
"Sheridan",2014,"16","357","5","12","2","376"
"Sheridan",2014,"17","362","8","9","0","379"
"Sheridan",2014,"18 to 20","987","28","33","21","1069"
"Sheridan",2014,"21 to 24","1270","33","37","14","1354"
"Sheridan",2014,"25 & over","20439","190","250","187","21066"
"Sheridan",2014,"Total","28900","360","452","282","29994"
"Sheridan",1993,"0","262","0","2","0","264"
"Sheridan",1993,"1","265","1","4","3","273"
"Sheridan",1993,"2","275","0","4","0","279"
"Sheridan",1993,"3","294","0","3","0","297"
"Sheridan",1993,"4","284","0","6","5","295"
"Sheridan",1993,"5","305","2","6","2","315"
"Sheridan",1993,"6","337","0","4","2","343"
"Sheridan",1993,"7","368","0","2","0","370"
"Sheridan",1993,"8","350","0","7","0","357"
"Sheridan",1993,"9","364","0","3","0","367"
"Sheridan",1993,"10","417","0","2","1","420"
"Sheridan",1993,"11","401","0","4","1","406"
"Sheridan",1993,"12","413","4","5","0","422"
"Sheridan",1993,"13","410","0","0","0","410"
"Sheridan",1993,"14","419","0","10","5","434"
"Sheridan",1993,"15","422","0","10","1","433"
"Sheridan",1993,"16","392","0","2","3","397"
"Sheridan",1993,"17","413","0","3","6","422"
"Sheridan",1993,"18 to 20","950","14","11","0","975"
"Sheridan",1993,"21 to 24","850","0","10","9","869"
"Sheridan",1993,"25 & over","16228","12","148","51","16439"
"Sheridan",1993,"Total","24419","33","246","89","24787"
"Goshen",1998,"0","145","0","2","0","147"
"Goshen",1998,"1","147","2","5","0","154"
"Goshen",1998,"2","141","0","1","0","142"
"Goshen",1998,"3","150","0","1","0","151"
"Goshen",1998,"4","148","0","1","0","149"
"Goshen",1998,"5","128","1","2","0","131"
"Goshen",1998,"6","178","0","10","0","188"
"Goshen",1998,"7","132","0","1","0","133"
"Goshen",1998,"8","189","0","4","0","193"
"Goshen",1998,"9","192","0","2","0","194"
"Goshen",1998,"10","186","6","2","3","197"
"Goshen",1998,"11","182","0","9","0","191"
"Goshen",1998,"12","193","0","4","0","197"
"Goshen",1998,"13","201","0","0","0","201"
"Goshen",1998,"14","196","0","0","0","196"
"Goshen",1998,"15","218","0","4","0","222"
"Goshen",1998,"16","207","0","0","0","207"
"Goshen",1998,"17","193","0","5","0","198"
"Goshen",1998,"18 to 20","658","5","6","6","675"
"Goshen",1998,"21 to 24","517","0","0","2","519"
"Goshen",1998,"25 & over","8196","6","34","8","8244"
"Goshen",1998,"Total","12497","20","93","19","12629"
"Park",1997,"0","284","0","2","1","287"
"Park",1997,"1","290","0","4","0","294"
"Park",1997,"2","311","0","4","4","319"
"Park",1997,"3","302","0","0","0","302"
"Park",1997,"4","299","0","1","6","306"
"Park",1997,"5","299","1","3","3","306"
"Park",1997,"6","314","0","0","0","314"
"Park",1997,"7","344","0","1","0","345"
"Park",1997,"8","360","0","3","0","363"
"Park",1997,"9","358","0","1","0","359"
"Park",1997,"10","358","0","3","0","361"
"Park",1997,"11","403","0","0","3","406"
"Park",1997,"12","439","0","9","4","452"
"Park",1997,"13","430","2","2","4","438"
"Park",1997,"14","430","2","0","2","434"
"Park",1997,"15","476","1","1","0","478"
"Park",1997,"16","430","0","6","1","437"
"Park",1997,"17","465","0","1","0","466"
"Park",1997,"18 to 20","1390","0","16","16","1422"
"Park",1997,"21 to 24","1006","0","2","10","1018"
"Park",1997,"25 & over","16641","9","71","61","16782"
"Park",1997,"Total","25629","15","130","115","25889"
"Laramie",2013,"0","1126","82","37","21","1266"
"Laramie",2013,"1","1091","74","20","19","1204"
"Laramie",2013,"2","1162","79","14","16","1271"
"Laramie",2013,"3","1180","66","21","23","1290"
"Laramie",2013,"4","1192","65","18","23","1298"
"Laramie",2013,"5","1276","78","25","28","1407"
"Laramie",2013,"6","1255","63","15","19","1352"
"Laramie",2013,"7","1226","63","30","23","1342"
"Laramie",2013,"8","1186","54","22","33","1295"
"Laramie",2013,"9","1201","45","26","26","1298"
"Laramie",2013,"10","1134","50","23","21","1228"
"Laramie",2013,"11","1123","37","21","21","1202"
"Laramie",2013,"12","1093","60","21","21","1195"
"Laramie",2013,"13","1137","43","14","11","1205"
"Laramie",2013,"14","1106","50","34","18","1208"
"Laramie",2013,"15","1083","63","27","19","1192"
"Laramie",2013,"16","1076","56","14","11","1157"
"Laramie",2013,"17","1090","74","21","28","1213"
"Laramie",2013,"18 to 20","3255","287","70","69","3681"
"Laramie",2013,"21 to 24","5245","428","84","134","5891"
"Laramie",2013,"25 & over","59927","2050","755","1002","63734"
"Laramie",2013,"Total","89164","3867","1312","1586","95929"
"Fremont",2013,"0","330","12","220","2","564"
"Fremont",2013,"1","332","10","265","0","607"
"Fremont",2013,"2","343","15","264","5","627"
"Fremont",2013,"3","368","8","238","6","620"
"Fremont",2013,"4","401","5","220","3","629"
"Fremont",2013,"5","380","6","239","5","630"
"Fremont",2013,"6","417","7","198","2","624"
"Fremont",2013,"7","383","3","248","1","635"
"Fremont",2013,"8","373","4","234","4","615"
"Fremont",2013,"9","349","4","219","4","576"
"Fremont",2013,"10","350","3","205","2","560"
"Fremont",2013,"11","354","6","194","2","556"
"Fremont",2013,"12","338","8","178","3","527"
"Fremont",2013,"13","334","6","172","0","512"
"Fremont",2013,"14","345","4","163","3","515"
"Fremont",2013,"15","349","4","184","3","540"
"Fremont",2013,"16","346","5","166","3","520"
"Fremont",2013,"17","383","5","161","4","553"
"Fremont",2013,"18 to 20","984","27","448","9","1468"
"Fremont",2013,"21 to 24","1367","30","593","9","1999"
"Fremont",2013,"25 & over","22218","276","4473","166","27133"
"Fremont",2013,"Total","31044","448","9282","236","41010"
"Sweetwater",2000,"0","508","10","7","1","526"
"Sweetwater",2000,"1","523","10","13","0","546"
"Sweetwater",2000,"2","479","9","11","0","499"
"Sweetwater",2000,"3","489","8","8","3","508"
"Sweetwater",2000,"4","472","9","5","1","487"
"Sweetwater",2000,"5","468","6","6","3","483"
"Sweetwater",2000,"6","551","6","13","2","572"
"Sweetwater",2000,"7","529","8","13","3","553"
"Sweetwater",2000,"8","590","6","6","3","605"
"Sweetwater",2000,"9","582","10","11","3","606"
"Sweetwater",2000,"10","560","5","8","1","574"
"Sweetwater",2000,"11","582","8","13","2","605"
"Sweetwater",2000,"12","611","10","9","2","632"
"Sweetwater",2000,"13","686","6","8","0","700"
"Sweetwater",2000,"14","677","9","7","2","695"
"Sweetwater",2000,"15","689","10","7","1","707"
"Sweetwater",2000,"16","723","8","7","5","743"
"Sweetwater",2000,"17","770","3","9","6","788"
"Sweetwater",2000,"18 to 20","1901","18","24","27","1970"
"Sweetwater",2000,"21 to 24","1740","16","29","35","1820"
"Sweetwater",2000,"25 & over","22330","172","254","177","22933"
"Sweetwater",2000,"Total","36460","347","468","277","37552"
"Park",1994,"0","288","0","1","1","290"
"Park",1994,"1","304","0","4","0","308"
"Park",1994,"2","316","0","3","3","322"
"Park",1994,"3","322","0","0","0","322"
"Park",1994,"4","337","0","2","2","341"
"Park",1994,"5","324","1","2","6","333"
"Park",1994,"6","327","0","0","0","327"
"Park",1994,"7","349","0","2","0","351"
"Park",1994,"8","371","0","2","0","373"
"Park",1994,"9","393","0","2","0","395"
"Park",1994,"10","382","0","5","0","387"
"Park",1994,"11","425","0","0","4","429"
"Park",1994,"12","441","0","8","3","452"
"Park",1994,"13","421","1","2","2","426"
"Park",1994,"14","421","1","0","2","424"
"Park",1994,"15","418","1","3","0","422"
"Park",1994,"16","392","0","6","2","400"
"Park",1994,"17","406","0","1","0","407"
"Park",1994,"18 to 20","1337","0","12","12","1361"
"Park",1994,"21 to 24","1009","0","2","14","1025"
"Park",1994,"25 & over","15760","11","63","58","15892"
"Park",1994,"Total","24743","15","120","109","24987"
"Hot Springs",2005,"0","40","0","1","0","41"
"Hot Springs",2005,"1","34","2","2","0","38"
"Hot Springs",2005,"2","34","3","2","0","39"
"Hot Springs",2005,"3","44","1","1","0","46"
"Hot Springs",2005,"4","45","2","0","0","47"
"Hot Springs",2005,"5","48","0","2","0","50"
"Hot Springs",2005,"6","49","0","0","0","49"
"Hot Springs",2005,"7","44","2","0","1","47"
"Hot Springs",2005,"8","44","1","1","0","46"
"Hot Springs",2005,"9","68","1","2","0","71"
"Hot Springs",2005,"10","36","0","1","0","37"
"Hot Springs",2005,"11","49","0","2","0","51"
"Hot Springs",2005,"12","58","0","0","1","59"
"Hot Springs",2005,"13","45","1","2","1","49"
"Hot Springs",2005,"14","52","1","2","1","56"
"Hot Springs",2005,"15","48","0","1","0","49"
"Hot Springs",2005,"16","55","0","3","0","58"
"Hot Springs",2005,"17","71","1","1","0","73"
"Hot Springs",2005,"18 to 20","161","0","4","1","166"
"Hot Springs",2005,"21 to 24","181","3","10","2","196"
"Hot Springs",2005,"25 & over","3277","9","39","11","3336"
"Hot Springs",2005,"Total","4483","27","76","18","4604"
"Sublette",2015,"0","115","0","0","2","117"
"Sublette",2015,"1","121","3","1","2","127"
"Sublette",2015,"2","148","1","0","1","150"
"Sublette",2015,"3","138","1","0","0","139"
"Sublette",2015,"4","136","1","0","0","137"
"Sublette",2015,"5","116","2","1","0","119"
"Sublette",2015,"6","140","4","0","1","145"
"Sublette",2015,"7","155","2","1","1","159"
"Sublette",2015,"8","137","3","2","1","143"
"Sublette",2015,"9","115","2","1","0","118"
"Sublette",2015,"10","112","1","1","1","115"
"Sublette",2015,"11","124","2","3","2","131"
"Sublette",2015,"12","125","2","1","0","128"
"Sublette",2015,"13","124","0","1","13","138"
"Sublette",2015,"14","109","1","2","15","127"
"Sublette",2015,"15","118","2","2","4","126"
"Sublette",2015,"16","128","1","1","1","131"
"Sublette",2015,"17","115","2","3","1","121"
"Sublette",2015,"18 to 20","252","3","10","1","266"
"Sublette",2015,"21 to 24","369","6","6","3","384"
"Sublette",2015,"25 & over","6636","97","64","59","6856"
"Sublette",2015,"Total","9533","136","100","108","9877"
"Niobrara",2004,"0","13","1","0","0","14"
"Niobrara",2004,"1","25","1","0","0","26"
"Niobrara",2004,"2","15","1","0","0","16"
"Niobrara",2004,"3","27","0","0","0","27"
"Niobrara",2004,"4","13","0","1","0","14"
"Niobrara",2004,"5","18","0","0","0","18"
"Niobrara",2004,"6","21","0","0","0","21"
"Niobrara",2004,"7","38","0","0","0","38"
"Niobrara",2004,"8","22","0","0","0","22"
"Niobrara",2004,"9","30","1","0","0","31"
"Niobrara",2004,"10","21","0","1","0","22"
"Niobrara",2004,"11","30","0","0","0","30"
"Niobrara",2004,"12","22","1","0","0","23"
"Niobrara",2004,"13","35","0","0","0","35"
"Niobrara",2004,"14","30","0","0","0","30"
"Niobrara",2004,"15","34","0","0","0","34"
"Niobrara",2004,"16","30","0","0","1","31"
"Niobrara",2004,"17","44","0","0","0","44"
"Niobrara",2004,"18 to 20","68","1","0","0","69"
"Niobrara",2004,"21 to 24","85","1","2","0","88"
"Niobrara",2004,"25 & over","1671","1","10","4","1686"
"Niobrara",2004,"Total","2292","8","14","5","2319"
"Niobrara",2002,"0","14","0","0","0","14"
"Niobrara",2002,"1","26","1","0","0","27"
"Niobrara",2002,"2","15","1","0","0","16"
"Niobrara",2002,"3","22","0","0","0","22"
"Niobrara",2002,"4","19","0","0","0","19"
"Niobrara",2002,"5","29","0","0","0","29"
"Niobrara",2002,"6","23","0","0","0","23"
"Niobrara",2002,"7","29","0","0","0","29"
"Niobrara",2002,"8","16","0","0","0","16"
"Niobrara",2002,"9","31","1","0","0","32"
"Niobrara",2002,"10","30","0","1","0","31"
"Niobrara",2002,"11","37","0","0","0","37"
"Niobrara",2002,"12","31","1","0","0","32"
"Niobrara",2002,"13","32","0","0","0","32"
"Niobrara",2002,"14","27","0","0","0","27"
"Niobrara",2002,"15","39","0","0","0","39"
"Niobrara",2002,"16","32","0","0","0","32"
"Niobrara",2002,"17","42","0","0","0","42"
"Niobrara",2002,"18 to 20","73","1","0","0","74"
"Niobrara",2002,"21 to 24","62","1","1","0","64"
"Niobrara",2002,"25 & over","1643","1","10","2","1656"
"Niobrara",2002,"Total","2272","7","12","2","2293"
"Niobrara",1994,"0","23","0","0","0","23"
"Niobrara",1994,"1","25","0","0","0","25"
"Niobrara",1994,"2","26","0","0","0","26"
"Niobrara",1994,"3","31","0","0","0","31"
"Niobrara",1994,"4","24","0","0","0","24"
"Niobrara",1994,"5","30","0","0","0","30"
"Niobrara",1994,"6","25","0","0","0","25"
"Niobrara",1994,"7","37","0","0","0","37"
"Niobrara",1994,"8","33","0","0","0","33"
"Niobrara",1994,"9","34","0","0","0","34"
"Niobrara",1994,"10","34","0","0","0","34"
"Niobrara",1994,"11","40","0","0","0","40"
"Niobrara",1994,"12","35","0","0","0","35"
"Niobrara",1994,"13","40","0","0","0","40"
"Niobrara",1994,"14","41","0","0","0","41"
"Niobrara",1994,"15","41","0","0","0","41"
"Niobrara",1994,"16","34","0","0","0","34"
"Niobrara",1994,"17","37","0","0","0","37"
"Niobrara",1994,"18 to 20","69","1","0","0","70"
"Niobrara",1994,"21 to 24","64","0","0","0","64"
"Niobrara",1994,"25 & over","1718","1","3","0","1722"
"Niobrara",1994,"Total","2441","2","3","0","2446"
"Teton",1998,"0","184","0","3","1","188"
"Teton",1998,"1","181","2","0","1","184"
"Teton",1998,"2","188","0","1","0","189"
"Teton",1998,"3","184","0","0","1","185"
"Teton",1998,"4","161","0","2","0","163"
"Teton",1998,"5","174","0","2","0","176"
"Teton",1998,"6","170","0","0","0","170"
"Teton",1998,"7","176","1","1","0","178"
"Teton",1998,"8","201","0","0","2","203"
"Teton",1998,"9","190","2","0","0","192"
"Teton",1998,"10","212","1","1","0","214"
"Teton",1998,"11","212","0","0","0","212"
"Teton",1998,"12","200","0","0","0","200"
"Teton",1998,"13","217","0","0","0","217"
"Teton",1998,"14","197","0","1","3","201"
"Teton",1998,"15","197","1","2","1","201"
"Teton",1998,"16","225","0","2","0","227"
"Teton",1998,"17","195","0","0","0","195"
"Teton",1998,"18 to 20","474","1","6","0","481"
"Teton",1998,"21 to 24","1115","4","3","6","1128"
"Teton",1998,"25 & over","11671","8","54","46","11779"
"Teton",1998,"Total","16724","20","78","61","16883"
"Carbon",2009,"0","229","3","3","4","239"
"Carbon",2009,"1","227","4","2","0","233"
"Carbon",2009,"2","211","1","0","4","216"
"Carbon",2009,"3","232","4","2","1","239"
"Carbon",2009,"4","213","5","2","2","222"
"Carbon",2009,"5","197","8","3","3","211"
"Carbon",2009,"6","220","4","0","1","225"
"Carbon",2009,"7","168","4","1","0","173"
"Carbon",2009,"8","207","1","5","2","215"
"Carbon",2009,"9","179","10","5","2","196"
"Carbon",2009,"10","221","2","5","2","230"
"Carbon",2009,"11","215","2","6","0","223"
"Carbon",2009,"12","172","0","2","1","175"
"Carbon",2009,"13","199","2","3","2","206"
"Carbon",2009,"14","191","0","5","2","198"
"Carbon",2009,"15","177","0","9","1","187"
"Carbon",2009,"16","215","4","1","1","221"
"Carbon",2009,"17","177","0","4","1","182"
"Carbon",2009,"18 to 20","473","7","6","4","490"
"Carbon",2009,"21 to 24","750","10","16","10","786"
"Carbon",2009,"25 & over","10582","89","145","94","10910"
"Carbon",2009,"Total","15455","160","225","137","15977"
"Natrona",1995,"0","838","11","7","2","858"
"Natrona",1995,"1","874","9","10","4","897"
"Natrona",1995,"2","824","11","12","1","848"
"Natrona",1995,"3","875","13","17","9","914"
"Natrona",1995,"4","902","9","9","5","925"
"Natrona",1995,"5","944","18","13","7","982"
"Natrona",1995,"6","931","11","11","0","953"
"Natrona",1995,"7","932","20","5","5","962"
"Natrona",1995,"8","967","12","8","1","988"
"Natrona",1995,"9","998","13","11","10","1032"
"Natrona",1995,"10","1120","12","14","5","1151"
"Natrona",1995,"11","1059","14","8","5","1086"
"Natrona",1995,"12","1091","11","17","8","1127"
"Natrona",1995,"13","1094","9","14","7","1124"
"Natrona",1995,"14","1063","16","17","6","1102"
"Natrona",1995,"15","1138","14","16","9","1177"
"Natrona",1995,"16","1013","7","9","3","1032"
"Natrona",1995,"17","1052","8","7","3","1070"
"Natrona",1995,"18 to 20","2955","51","23","17","3046"
"Natrona",1995,"21 to 24","3119","32","41","17","3209"
"Natrona",1995,"25 & over","40471","246","329","158","41204"
"Natrona",1995,"Total","64260","547","598","282","65687"
"Sublette",1997,"0","63","0","0","0","63"
"Sublette",1997,"1","71","0","2","2","75"
"Sublette",1997,"2","64","0","0","0","64"
"Sublette",1997,"3","73","0","0","0","73"
"Sublette",1997,"4","72","0","0","0","72"
"Sublette",1997,"5","66","0","1","0","67"
"Sublette",1997,"6","82","0","0","0","82"
"Sublette",1997,"7","82","0","0","0","82"
"Sublette",1997,"8","79","0","2","0","81"
"Sublette",1997,"9","77","0","0","0","77"
"Sublette",1997,"10","83","0","4","0","87"
"Sublette",1997,"11","104","0","0","0","104"
"Sublette",1997,"12","98","0","0","0","98"
"Sublette",1997,"13","107","0","0","0","107"
"Sublette",1997,"14","95","0","0","0","95"
"Sublette",1997,"15","95","0","0","0","95"
"Sublette",1997,"16","96","0","0","0","96"
"Sublette",1997,"17","92","0","0","0","92"
"Sublette",1997,"18 to 20","161","0","0","0","161"
"Sublette",1997,"21 to 24","192","0","2","0","194"
"Sublette",1997,"25 & over","3800","2","15","2","3819"
"Sublette",1997,"Total","5652","2","26","4","5684"
"Hot Springs",1994,"0","48","0","0","0","48"
"Hot Springs",1994,"1","41","0","1","0","42"
"Hot Springs",1994,"2","42","0","6","0","48"
"Hot Springs",1994,"3","45","0","0","0","45"
"Hot Springs",1994,"4","51","0","1","0","52"
"Hot Springs",1994,"5","49","0","2","0","51"
"Hot Springs",1994,"6","52","0","2","0","54"
"Hot Springs",1994,"7","56","0","1","0","57"
"Hot Springs",1994,"8","59","0","3","0","62"
"Hot Springs",1994,"9","81","0","2","0","83"
"Hot Springs",1994,"10","72","0","2","0","74"
"Hot Springs",1994,"11","76","0","3","0","79"
"Hot Springs",1994,"12","86","0","5","0","91"
"Hot Springs",1994,"13","84","0","1","0","85"
"Hot Springs",1994,"14","96","0","3","0","99"
"Hot Springs",1994,"15","77","0","6","0","83"
"Hot Springs",1994,"16","81","0","3","0","84"
"Hot Springs",1994,"17","80","0","1","0","81"
"Hot Springs",1994,"18 to 20","137","1","1","0","139"
"Hot Springs",1994,"21 to 24","123","0","2","0","125"
"Hot Springs",1994,"25 & over","3348","0","37","0","3385"
"Hot Springs",1994,"Total","4784","1","82","0","4867"
"Campbell",2008,"0","710","4","66","4","784"
"Campbell",2008,"1","686","8","23","3","720"
"Campbell",2008,"2","724","8","12","2","746"
"Campbell",2008,"3","637","5","15","15","672"
"Campbell",2008,"4","629","3","10","3","645"
"Campbell",2008,"5","654","2","11","1","668"
"Campbell",2008,"6","672","8","22","10","712"
"Campbell",2008,"7","587","5","21","8","621"
"Campbell",2008,"8","601","8","8","1","618"
"Campbell",2008,"9","638","7","9","8","662"
"Campbell",2008,"10","622","5","14","5","646"
"Campbell",2008,"11","594","4","14","8","620"
"Campbell",2008,"12","675","8","10","3","696"
"Campbell",2008,"13","570","8","9","2","589"
"Campbell",2008,"14","617","7","12","8","644"
"Campbell",2008,"15","640","3","13","1","657"
"Campbell",2008,"16","625","4","11","2","642"
"Campbell",2008,"17","627","6","15","4","652"
"Campbell",2008,"18 to 20","1626","26","42","17","1711"
"Campbell",2008,"21 to 24","2588","13","52","23","2676"
"Campbell",2008,"25 & over","25838","99","346","182","26465"
"Campbell",2008,"Total","41560","241","735","310","42846"
"Carbon",1995,"0","177","0","0","1","178"
"Carbon",1995,"1","195","0","7","0","202"
"Carbon",1995,"2","187","3","0","0","190"
"Carbon",1995,"3","188","0","3","0","191"
"Carbon",1995,"4","201","0","0","0","201"
"Carbon",1995,"5","222","1","5","0","228"
"Carbon",1995,"6","215","1","1","0","217"
"Carbon",1995,"7","215","1","0","1","217"
"Carbon",1995,"8","218","5","9","1","233"
"Carbon",1995,"9","228","1","0","3","232"
"Carbon",1995,"10","255","4","5","3","267"
"Carbon",1995,"11","259","3","6","0","268"
"Carbon",1995,"12","281","4","0","3","288"
"Carbon",1995,"13","282","0","0","0","282"
"Carbon",1995,"14","296","0","0","2","298"
"Carbon",1995,"15","295","1","0","6","302"
"Carbon",1995,"16","276","0","0","2","278"
"Carbon",1995,"17","296","0","0","2","298"
"Carbon",1995,"18 to 20","562","5","13","3","583"
"Carbon",1995,"21 to 24","725","5","10","4","744"
"Carbon",1995,"25 & over","10281","60","97","39","10477"
"Carbon",1995,"Total","15854","94","156","70","16174"
"Crook",2004,"0","73","0","1","0","74"
"Crook",2004,"1","60","0","1","0","61"
"Crook",2004,"2","68","0","1","1","70"
"Crook",2004,"3","62","1","1","0","64"
"Crook",2004,"4","65","0","1","1","67"
"Crook",2004,"5","74","2","1","0","77"
"Crook",2004,"6","61","1","3","0","65"
"Crook",2004,"7","57","1","0","0","58"
"Crook",2004,"8","76","0","2","1","79"
"Crook",2004,"9","60","0","1","0","61"
"Crook",2004,"10","77","1","0","0","78"
"Crook",2004,"11","87","0","2","0","89"
"Crook",2004,"12","90","0","1","0","91"
"Crook",2004,"13","98","0","0","0","98"
"Crook",2004,"14","94","0","1","0","95"
"Crook",2004,"15","95","0","4","0","99"
"Crook",2004,"16","101","0","1","0","102"
"Crook",2004,"17","117","0","1","0","118"
"Crook",2004,"18 to 20","235","1","1","0","237"
"Crook",2004,"21 to 24","260","0","3","0","263"
"Crook",2004,"25 & over","4061","6","35","4","4106"
"Crook",2004,"Total","5971","13","61","7","6052"
"Platte",2010,"0","72","2","0","1","75"
"Platte",2010,"1","78","2","2","0","82"
"Platte",2010,"2","84","2","2","0","88"
"Platte",2010,"3","88","1","1","2","92"
"Platte",2010,"4","82","0","1","1","84"
"Platte",2010,"5","87","1","1","1","90"
"Platte",2010,"6","89","1","0","0","90"
"Platte",2010,"7","94","2","0","0","96"
"Platte",2010,"8","102","2","1","0","105"
"Platte",2010,"9","91","0","0","0","91"
"Platte",2010,"10","97","0","1","2","100"
"Platte",2010,"11","100","0","0","0","100"
"Platte",2010,"12","99","3","0","0","102"
"Platte",2010,"13","102","1","0","1","104"
"Platte",2010,"14","94","0","1","2","97"
"Platte",2010,"15","114","3","1","1","119"
"Platte",2010,"16","117","0","1","2","120"
"Platte",2010,"17","115","0","2","2","119"
"Platte",2010,"18 to 20","237","1","2","4","244"
"Platte",2010,"21 to 24","294","2","2","3","301"
"Platte",2010,"25 & over","6297","25","34","22","6378"
"Platte",2010,"Total","8533","48","52","44","8677"
"Sublette",1990,"0","71","0","0","0","71"
"Sublette",1990,"1","73","0","3","2","78"
"Sublette",1990,"2","73","0","0","0","73"
"Sublette",1990,"3","72","0","0","0","72"
"Sublette",1990,"4","79","0","0","0","79"
"Sublette",1990,"5","69","0","4","0","73"
"Sublette",1990,"6","64","0","0","0","64"
"Sublette",1990,"7","86","0","0","0","86"
"Sublette",1990,"8","73","0","3","0","76"
"Sublette",1990,"9","80","0","0","0","80"
"Sublette",1990,"10","78","0","9","0","87"
"Sublette",1990,"11","92","0","0","0","92"
"Sublette",1990,"12","72","0","0","0","72"
"Sublette",1990,"13","81","0","0","0","81"
"Sublette",1990,"14","67","0","0","0","67"
"Sublette",1990,"15","80","0","0","0","80"
"Sublette",1990,"16","75","0","0","0","75"
"Sublette",1990,"17","69","0","0","0","69"
"Sublette",1990,"18 to 20","143","0","0","0","143"
"Sublette",1990,"21 to 24","157","0","5","0","162"
"Sublette",1990,"25 & over","3173","2","26","2","3203"
"Sublette",1990,"Total","4827","2","50","4","4883"
"Hot Springs",2007,"0","48","0","1","0","49"
"Hot Springs",2007,"1","43","2","3","0","48"
"Hot Springs",2007,"2","42","2","2","0","46"
"Hot Springs",2007,"3","37","1","1","0","39"
"Hot Springs",2007,"4","43","1","0","0","44"
"Hot Springs",2007,"5","54","0","2","0","56"
"Hot Springs",2007,"6","44","1","0","0","45"
"Hot Springs",2007,"7","53","1","0","1","55"
"Hot Springs",2007,"8","65","1","1","0","67"
"Hot Springs",2007,"9","46","1","2","0","49"
"Hot Springs",2007,"10","42","0","1","0","43"
"Hot Springs",2007,"11","67","1","1","0","69"
"Hot Springs",2007,"12","51","0","0","1","52"
"Hot Springs",2007,"13","42","1","2","1","46"
"Hot Springs",2007,"14","51","2","0","1","54"
"Hot Springs",2007,"15","53","0","2","1","56"
"Hot Springs",2007,"16","45","1","2","0","48"
"Hot Springs",2007,"17","50","1","1","0","52"
"Hot Springs",2007,"18 to 20","145","0","4","1","150"
"Hot Springs",2007,"21 to 24","179","4","9","2","194"
"Hot Springs",2007,"25 & over","3327","7","40","11","3385"
"Hot Springs",2007,"Total","4527","27","74","19","4647"
"Converse",2012,"0","193","5","5","0","203"
"Converse",2012,"1","147","2","5","1","155"
"Converse",2012,"2","202","2","5","1","210"
"Converse",2012,"3","181","5","1","1","188"
"Converse",2012,"4","188","3","2","1","194"
"Converse",2012,"5","194","3","0","3","200"
"Converse",2012,"6","186","4","4","0","194"
"Converse",2012,"7","201","4","3","2","210"
"Converse",2012,"8","186","3","3","1","193"
"Converse",2012,"9","174","2","2","1","179"
"Converse",2012,"10","195","3","4","1","203"
"Converse",2012,"11","190","4","0","2","196"
"Converse",2012,"12","198","3","1","5","207"
"Converse",2012,"13","195","6","2","1","204"
"Converse",2012,"14","184","4","2","0","190"
"Converse",2012,"15","182","3","2","0","187"
"Converse",2012,"16","184","7","2","0","193"
"Converse",2012,"17","185","6","0","0","191"
"Converse",2012,"18 to 20","475","10","6","2","493"
"Converse",2012,"21 to 24","591","9","6","1","607"
"Converse",2012,"25 & over","9198","93","98","49","9438"
"Converse",2012,"Total","13629","181","153","72","14035"
"Washakie",2013,"0","85","2","6","0","93"
"Washakie",2013,"1","92","2","4","0","98"
"Washakie",2013,"2","105","3","1","0","109"
"Washakie",2013,"3","100","2","0","0","102"
"Washakie",2013,"4","101","2","1","1","105"
"Washakie",2013,"5","96","1","1","2","100"
"Washakie",2013,"6","108","0","3","1","112"
"Washakie",2013,"7","123","0","4","0","127"
"Washakie",2013,"8","118","0","2","1","121"
"Washakie",2013,"9","116","1","1","2","120"
"Washakie",2013,"10","119","1","3","2","125"
"Washakie",2013,"11","113","1","3","0","117"
"Washakie",2013,"12","116","1","2","0","119"
"Washakie",2013,"13","118","0","2","2","122"
"Washakie",2013,"14","117","0","3","2","122"
"Washakie",2013,"15","118","0","7","0","125"
"Washakie",2013,"16","118","0","1","2","121"
"Washakie",2013,"17","120","3","4","0","127"
"Washakie",2013,"18 to 20","246","6","9","5","266"
"Washakie",2013,"21 to 24","277","7","9","4","297"
"Washakie",2013,"25 & over","5627","52","84","51","5814"
"Washakie",2013,"Total","8133","84","150","75","8442"
"Big Horn",2012,"0","132","0","2","0","134"
"Big Horn",2012,"1","162","0","1","2","165"
"Big Horn",2012,"2","142","5","5","0","152"
"Big Horn",2012,"3","151","2","2","0","155"
"Big Horn",2012,"4","145","1","1","0","147"
"Big Horn",2012,"5","167","1","0","0","168"
"Big Horn",2012,"6","160","1","1","2","164"
"Big Horn",2012,"7","182","1","0","1","184"
"Big Horn",2012,"8","145","1","0","2","148"
"Big Horn",2012,"9","166","1","2","2","171"
"Big Horn",2012,"10","159","2","0","0","161"
"Big Horn",2012,"11","162","2","3","3","170"
"Big Horn",2012,"12","168","1","4","2","175"
"Big Horn",2012,"13","152","3","1","0","156"
"Big Horn",2012,"14","183","2","1","2","188"
"Big Horn",2012,"15","176","2","0","2","180"
"Big Horn",2012,"16","183","2","2","1","188"
"Big Horn",2012,"17","196","4","2","2","204"
"Big Horn",2012,"18 to 20","387","19","3","2","411"
"Big Horn",2012,"21 to 24","443","15","16","0","474"
"Big Horn",2012,"25 & over","7674","73","108","31","7886"
"Big Horn",2012,"Total","11435","138","154","54","11781"
"Niobrara",1998,"0","16","0","0","0","16"
"Niobrara",1998,"1","27","0","0","0","27"
"Niobrara",1998,"2","22","0","0","0","22"
"Niobrara",1998,"3","31","0","0","0","31"
"Niobrara",1998,"4","25","0","0","0","25"
"Niobrara",1998,"5","31","0","0","0","31"
"Niobrara",1998,"6","22","0","0","0","22"
"Niobrara",1998,"7","37","0","0","0","37"
"Niobrara",1998,"8","30","0","0","0","30"
"Niobrara",1998,"9","33","0","0","0","33"
"Niobrara",1998,"10","34","0","0","0","34"
"Niobrara",1998,"11","39","0","0","0","39"
"Niobrara",1998,"12","34","0","0","0","34"
"Niobrara",1998,"13","41","0","0","0","41"
"Niobrara",1998,"14","37","0","0","0","37"
"Niobrara",1998,"15","42","0","0","0","42"
"Niobrara",1998,"16","35","0","0","0","35"
"Niobrara",1998,"17","42","0","0","0","42"
"Niobrara",1998,"18 to 20","80","1","0","0","81"
"Niobrara",1998,"21 to 24","72","0","0","0","72"
"Niobrara",1998,"25 & over","1776","1","2","0","1779"
"Niobrara",1998,"Total","2506","2","2","0","2510"
"Johnson",1995,"0","66","0","1","0","67"
"Johnson",1995,"1","76","0","0","0","76"
"Johnson",1995,"2","71","0","0","0","71"
"Johnson",1995,"3","74","0","0","0","74"
"Johnson",1995,"4","77","0","0","0","77"
"Johnson",1995,"5","83","0","1","0","84"
"Johnson",1995,"6","83","0","3","0","86"
"Johnson",1995,"7","89","0","0","0","89"
"Johnson",1995,"8","89","0","4","0","93"
"Johnson",1995,"9","99","0","2","0","101"
"Johnson",1995,"10","111","0","1","0","112"
"Johnson",1995,"11","108","0","0","0","108"
"Johnson",1995,"12","106","0","0","0","106"
"Johnson",1995,"13","99","0","2","0","101"
"Johnson",1995,"14","116","0","5","0","121"
"Johnson",1995,"15","111","0","1","1","113"
"Johnson",1995,"16","117","0","0","0","117"
"Johnson",1995,"17","115","0","0","0","115"
"Johnson",1995,"18 to 20","205","0","0","0","205"
"Johnson",1995,"21 to 24","198","0","0","0","198"
"Johnson",1995,"25 & over","4542","0","16","0","4558"
"Johnson",1995,"Total","6635","0","36","1","6672"
"Crook",1998,"0","63","0","0","0","63"
"Crook",1998,"1","65","0","2","0","67"
"Crook",1998,"2","62","0","0","0","62"
"Crook",1998,"3","56","0","0","0","56"
"Crook",1998,"4","68","0","0","0","68"
"Crook",1998,"5","73","0","2","0","75"
"Crook",1998,"6","84","0","0","0","84"
"Crook",1998,"7","86","0","0","0","86"
"Crook",1998,"8","87","0","0","0","87"
"Crook",1998,"9","83","0","0","0","83"
"Crook",1998,"10","94","0","5","0","99"
"Crook",1998,"11","107","0","0","0","107"
"Crook",1998,"12","102","0","0","0","102"
"Crook",1998,"13","122","0","0","0","122"
"Crook",1998,"14","109","0","0","0","109"
"Crook",1998,"15","116","0","6","0","122"
"Crook",1998,"16","118","0","0","0","118"
"Crook",1998,"17","119","0","0","0","119"
"Crook",1998,"18 to 20","222","0","3","0","225"
"Crook",1998,"21 to 24","184","0","0","0","184"
"Crook",1998,"25 & over","3799","0","14","0","3813"
"Crook",1998,"Total","5819","0","32","0","5851"
"Albany",1993,"0","354","2","4","15","375"
"Albany",1993,"1","343","11","5","16","375"
"Albany",1993,"2","357","2","5","10","374"
"Albany",1993,"3","365","0","6","5","376"
"Albany",1993,"4","345","10","4","11","370"
"Albany",1993,"5","342","6","3","7","358"
"Albany",1993,"6","337","6","7","2","352"
"Albany",1993,"7","353","3","4","9","369"
"Albany",1993,"8","358","7","4","1","370"
"Albany",1993,"9","371","5","4","8","388"
"Albany",1993,"10","393","5","5","2","405"
"Albany",1993,"11","365","3","3","7","378"
"Albany",1993,"12","364","8","5","10","387"
"Albany",1993,"13","372","5","10","5","392"
"Albany",1993,"14","341","0","7","3","351"
"Albany",1993,"15","343","8","9","4","364"
"Albany",1993,"16","352","0","6","1","359"
"Albany",1993,"17","343","6","2","6","357"
"Albany",1993,"18 to 20","3954","59","24","54","4091"
"Albany",1993,"21 to 24","4473","48","31","123","4675"
"Albany",1993,"25 & over","16179","108","123","351","16761"
"Albany",1993,"Total","31004","302","271","650","32227"
"Goshen",2010,"0","137","3","3","1","144"
"Goshen",2010,"1","138","1","1","2","142"
"Goshen",2010,"2","129","5","0","3","137"
"Goshen",2010,"3","158","3","3","0","164"
"Goshen",2010,"4","118","3","1","1","123"
"Goshen",2010,"5","115","0","0","0","115"
"Goshen",2010,"6","138","0","2","4","144"
"Goshen",2010,"7","138","1","3","2","144"
"Goshen",2010,"8","131","2","0","0","133"
"Goshen",2010,"9","146","1","3","1","151"
"Goshen",2010,"10","155","1","1","1","158"
"Goshen",2010,"11","140","0","0","1","141"
"Goshen",2010,"12","159","1","5","1","166"
"Goshen",2010,"13","168","3","2","2","175"
"Goshen",2010,"14","158","3","1","1","163"
"Goshen",2010,"15","149","3","2","0","154"
"Goshen",2010,"16","175","4","3","0","182"
"Goshen",2010,"17","162","2","3","0","167"
"Goshen",2010,"18 to 20","689","14","10","5","718"
"Goshen",2010,"21 to 24","622","13","8","2","645"
"Goshen",2010,"25 & over","9182","54","71","32","9339"
"Goshen",2010,"Total","13107","117","122","59","13405"
"Sweetwater",2014,"0","585","13","23","6","627"
"Sweetwater",2014,"1","654","13","7","11","685"
"Sweetwater",2014,"2","540","20","15","5","580"
"Sweetwater",2014,"3","639","9","8","8","664"
"Sweetwater",2014,"4","636","16","14","4","670"
"Sweetwater",2014,"5","736","21","10","9","776"
"Sweetwater",2014,"6","731","15","14","8","768"
"Sweetwater",2014,"7","725","12","12","9","758"
"Sweetwater",2014,"8","709","18","11","6","744"
"Sweetwater",2014,"9","678","13","11","6","708"
"Sweetwater",2014,"10","651","11","12","11","685"
"Sweetwater",2014,"11","643","11","14","10","678"
"Sweetwater",2014,"12","634","14","8","3","659"
"Sweetwater",2014,"13","605","12","10","10","637"
"Sweetwater",2014,"14","624","10","9","7","650"
"Sweetwater",2014,"15","620","13","8","4","645"
"Sweetwater",2014,"16","588","17","11","4","620"
"Sweetwater",2014,"17","599","14","15","4","632"
"Sweetwater",2014,"18 to 20","1589","53","34","27","1703"
"Sweetwater",2014,"21 to 24","2197","57","42","30","2326"
"Sweetwater",2014,"25 & over","27632","431","394","298","28755"
"Sweetwater",2014,"Total","43015","793","682","480","44970"
"Sweetwater",1993,"0","546","5","7","2","560"
"Sweetwater",1993,"1","584","6","8","5","603"
"Sweetwater",1993,"2","586","4","12","2","604"
"Sweetwater",1993,"3","619","14","8","2","643"
"Sweetwater",1993,"4","601","7","8","2","618"
"Sweetwater",1993,"5","599","12","4","5","620"
"Sweetwater",1993,"6","679","10","11","3","703"
"Sweetwater",1993,"7","724","3","11","5","743"
"Sweetwater",1993,"8","728","2","4","3","737"
"Sweetwater",1993,"9","816","3","7","6","832"
"Sweetwater",1993,"10","817","4","13","1","835"
"Sweetwater",1993,"11","830","3","7","5","845"
"Sweetwater",1993,"12","844","7","7","2","860"
"Sweetwater",1993,"13","884","9","10","4","907"
"Sweetwater",1993,"14","774","9","11","3","797"
"Sweetwater",1993,"15","739","6","7","2","754"
"Sweetwater",1993,"16","757","8","9","4","778"
"Sweetwater",1993,"17","721","4","7","6","738"
"Sweetwater",1993,"18 to 20","1724","20","15","13","1772"
"Sweetwater",1993,"21 to 24","1716","20","17","15","1768"
"Sweetwater",1993,"25 & over","22843","156","191","159","23349"
"Sweetwater",1993,"Total","39131","312","374","249","40066"
"Uinta",2004,"0","319","3","9","0","331"
"Uinta",2004,"1","311","1","3","1","316"
"Uinta",2004,"2","313","2","3","1","319"
"Uinta",2004,"3","287","1","1","1","290"
"Uinta",2004,"4","301","4","1","2","308"
"Uinta",2004,"5","318","2","3","4","327"
"Uinta",2004,"6","304","2","4","2","312"
"Uinta",2004,"7","298","3","4","3","308"
"Uinta",2004,"8","350","3","3","0","356"
"Uinta",2004,"9","297","2","2","2","303"
"Uinta",2004,"10","317","3","3","2","325"
"Uinta",2004,"11","295","2","4","4","305"
"Uinta",2004,"12","313","1","5","0","319"
"Uinta",2004,"13","327","0","3","1","331"
"Uinta",2004,"14","348","1","7","2","358"
"Uinta",2004,"15","352","4","10","0","366"
"Uinta",2004,"16","397","1","7","4","409"
"Uinta",2004,"17","372","2","4","2","380"
"Uinta",2004,"18 to 20","849","4","21","2","876"
"Uinta",2004,"21 to 24","944","0","8","4","956"
"Uinta",2004,"25 & over","11469","20","127","59","11675"
"Uinta",2004,"Total","19081","61","232","96","19470"
"Natrona",2004,"0","946","20","17","5","988"
"Natrona",2004,"1","855","21","13","6","895"
"Natrona",2004,"2","896","31","14","9","950"
"Natrona",2004,"3","845","44","24","9","922"
"Natrona",2004,"4","795","26","16","9","846"
"Natrona",2004,"5","858","18","10","6","892"
"Natrona",2004,"6","801","20","22","12","855"
"Natrona",2004,"7","855","21","15","9","900"
"Natrona",2004,"8","852","15","11","3","881"
"Natrona",2004,"9","914","20","12","7","953"
"Natrona",2004,"10","929","17","13","7","966"
"Natrona",2004,"11","919","20","15","8","962"
"Natrona",2004,"12","937","18","14","6","975"
"Natrona",2004,"13","964","16","28","9","1017"
"Natrona",2004,"14","1078","13","16","4","1111"
"Natrona",2004,"15","931","8","11","9","959"
"Natrona",2004,"16","937","13","24","4","978"
"Natrona",2004,"17","989","9","12","6","1016"
"Natrona",2004,"18 to 20","2916","60","43","28","3047"
"Natrona",2004,"21 to 24","4066","71","71","40","4248"
"Natrona",2004,"25 & over","43491","392","507","284","44674"
"Natrona",2004,"Total","66774","873","908","480","69035"
"Fremont",2006,"0","288","5","301","2","596"
"Fremont",2006,"1","288","1","243","0","532"
"Fremont",2006,"2","300","4","217","1","522"
"Fremont",2006,"3","305","4","242","1","552"
"Fremont",2006,"4","318","4","127","7","456"
"Fremont",2006,"5","336","4","172","2","514"
"Fremont",2006,"6","365","2","126","4","497"
"Fremont",2006,"7","348","4","197","2","551"
"Fremont",2006,"8","320","5","186","3","514"
"Fremont",2006,"9","316","7","126","1","450"
"Fremont",2006,"10","292","3","166","0","461"
"Fremont",2006,"11","321","3","143","5","472"
"Fremont",2006,"12","380","4","182","2","568"
"Fremont",2006,"13","329","2","197","2","530"
"Fremont",2006,"14","370","3","202","2","577"
"Fremont",2006,"15","405","0","185","3","593"
"Fremont",2006,"16","374","3","133","2","512"
"Fremont",2006,"17","401","0","209","4","614"
"Fremont",2006,"18 to 20","1041","5","447","7","1500"
"Fremont",2006,"21 to 24","1295","8","472","7","1782"
"Fremont",2006,"25 & over","20476","58","3977","104","24615"
"Fremont",2006,"Total","28868","129","8250","161","37408"
"Platte",2006,"0","86","2","0","0","88"
"Platte",2006,"1","89","0","2","0","91"
"Platte",2006,"2","82","2","2","0","86"
"Platte",2006,"3","72","1","1","2","76"
"Platte",2006,"4","85","2","0","1","88"
"Platte",2006,"5","94","1","0","0","95"
"Platte",2006,"6","93","2","0","0","95"
"Platte",2006,"7","111","2","0","0","113"
"Platte",2006,"8","97","2","0","0","99"
"Platte",2006,"9","87","0","0","0","87"
"Platte",2006,"10","105","0","1","2","108"
"Platte",2006,"11","112","1","0","0","113"
"Platte",2006,"12","116","1","0","0","117"
"Platte",2006,"13","128","1","0","1","130"
"Platte",2006,"14","129","0","1","1","131"
"Platte",2006,"15","131","3","1","0","135"
"Platte",2006,"16","166","0","0","1","167"
"Platte",2006,"17","118","0","2","1","121"
"Platte",2006,"18 to 20","255","1","1","2","259"
"Platte",2006,"21 to 24","308","1","3","1","313"
"Platte",2006,"25 & over","6102","24","32","20","6178"
"Platte",2006,"Total","8566","46","46","32","8690"
"Big Horn",2014,"0","154","2","1","0","157"
"Big Horn",2014,"1","126","3","4","0","133"
"Big Horn",2014,"2","143","2","1","0","146"
"Big Horn",2014,"3","165","0","2","3","170"
"Big Horn",2014,"4","133","4","4","0","141"
"Big Horn",2014,"5","151","3","3","0","157"
"Big Horn",2014,"6","158","4","1","0","163"
"Big Horn",2014,"7","170","1","2","0","173"
"Big Horn",2014,"8","166","2","2","2","172"
"Big Horn",2014,"9","194","0","0","0","194"
"Big Horn",2014,"10","161","3","0","3","167"
"Big Horn",2014,"11","161","1","2","2","166"
"Big Horn",2014,"12","165","2","0","0","167"
"Big Horn",2014,"13","163","1","3","2","169"
"Big Horn",2014,"14","180","1","4","2","187"
"Big Horn",2014,"15","172","3","1","0","176"
"Big Horn",2014,"16","183","1","1","2","187"
"Big Horn",2014,"17","187","2","0","2","191"
"Big Horn",2014,"18 to 20","404","14","5","6","429"
"Big Horn",2014,"21 to 24","450","8","16","3","477"
"Big Horn",2014,"25 & over","7746","74","125","31","7976"
"Big Horn",2014,"Total","11532","131","177","58","11898"
"Hot Springs",2001,"0","41","0","1","0","42"
"Hot Springs",2001,"1","44","2","2","0","48"
"Hot Springs",2001,"2","54","3","5","1","63"
"Hot Springs",2001,"3","38","0","0","0","38"
"Hot Springs",2001,"4","35","1","0","0","36"
"Hot Springs",2001,"5","53","0","1","0","54"
"Hot Springs",2001,"6","35","0","1","0","36"
"Hot Springs",2001,"7","49","1","1","0","51"
"Hot Springs",2001,"8","52","0","1","0","53"
"Hot Springs",2001,"9","55","0","2","0","57"
"Hot Springs",2001,"10","63","0","0","0","63"
"Hot Springs",2001,"11","59","0","4","0","63"
"Hot Springs",2001,"12","64","0","2","1","67"
"Hot Springs",2001,"13","66","0","2","0","68"
"Hot Springs",2001,"14","63","1","1","0","65"
"Hot Springs",2001,"15","84","0","4","0","88"
"Hot Springs",2001,"16","59","0","3","0","62"
"Hot Springs",2001,"17","87","0","0","0","87"
"Hot Springs",2001,"18 to 20","152","0","5","1","158"
"Hot Springs",2001,"21 to 24","106","1","4","0","111"
"Hot Springs",2001,"25 & over","3394","8","44","7","3453"
"Hot Springs",2001,"Total","4653","17","83","10","4763"
"Weston",1990,"0","80","0","2","0","82"
"Weston",1990,"1","81","0","0","0","81"
"Weston",1990,"2","88","0","2","0","90"
"Weston",1990,"3","87","0","1","0","88"
"Weston",1990,"4","95","0","2","0","97"
"Weston",1990,"5","108","0","0","0","108"
"Weston",1990,"6","108","0","0","0","108"
"Weston",1990,"7","124","0","0","0","124"
"Weston",1990,"8","122","0","0","0","122"
"Weston",1990,"9","136","0","6","0","142"
"Weston",1990,"10","125","0","5","0","130"
"Weston",1990,"11","129","0","1","0","130"
"Weston",1990,"12","115","0","0","0","115"
"Weston",1990,"13","125","0","0","0","125"
"Weston",1990,"14","101","0","0","0","101"
"Weston",1990,"15","121","0","0","0","121"
"Weston",1990,"16","88","0","0","0","88"
"Weston",1990,"17","85","0","2","0","87"
"Weston",1990,"18 to 20","192","0","12","0","204"
"Weston",1990,"21 to 24","214","0","6","0","220"
"Weston",1990,"25 & over","4109","0","29","5","4143"
"Weston",1990,"Total","6433","0","68","5","6506"
"Albany",2011,"0","389","9","4","14","416"
"Albany",2011,"1","386","11","3","9","409"
"Albany",2011,"2","384","12","6","14","416"
"Albany",2011,"3","356","12","6","9","383"
"Albany",2011,"4","356","12","7","12","387"
"Albany",2011,"5","336","13","8","10","367"
"Albany",2011,"6","319","9","6","13","347"
"Albany",2011,"7","316","9","3","10","338"
"Albany",2011,"8","273","6","3","8","290"
"Albany",2011,"9","279","9","7","10","305"
"Albany",2011,"10","304","6","2","10","322"
"Albany",2011,"11","258","7","6","6","277"
"Albany",2011,"12","248","7","4","5","264"
"Albany",2011,"13","272","11","2","9","294"
"Albany",2011,"14","292","5","3","14","314"
"Albany",2011,"15","286","6","4","8","304"
"Albany",2011,"16","300","4","4","6","314"
"Albany",2011,"17","289","13","3","10","315"
"Albany",2011,"18 to 20","4142","77","36","106","4361"
"Albany",2011,"21 to 24","6090","149","93","260","6592"
"Albany",2011,"25 & over","18763","242","212","663","19880"
"Albany",2011,"Total","34638","629","422","1206","36895"
"Weston",1997,"0","60","0","1","0","61"
"Weston",1997,"1","76","0","0","0","76"
"Weston",1997,"2","71","0","4","0","75"
"Weston",1997,"3","76","0","2","0","78"
"Weston",1997,"4","78","0","1","0","79"
"Weston",1997,"5","70","0","0","0","70"
"Weston",1997,"6","82","0","0","0","82"
"Weston",1997,"7","85","0","0","0","85"
"Weston",1997,"8","79","0","0","0","79"
"Weston",1997,"9","90","0","5","0","95"
"Weston",1997,"10","98","0","4","0","102"
"Weston",1997,"11","122","0","1","0","123"
"Weston",1997,"12","111","0","0","0","111"
"Weston",1997,"13","128","0","0","0","128"
"Weston",1997,"14","115","0","0","0","115"
"Weston",1997,"15","132","0","0","0","132"
"Weston",1997,"16","120","0","0","0","120"
"Weston",1997,"17","125","0","2","0","127"
"Weston",1997,"18 to 20","254","0","15","0","269"
"Weston",1997,"21 to 24","227","0","6","0","233"
"Weston",1997,"25 & over","4458","0","25","2","4485"
"Weston",1997,"Total","6657","0","66","2","6725"
"Goshen",2000,"0","141","1","3","1","146"
"Goshen",2000,"1","141","2","3","0","146"
"Goshen",2000,"2","136","2","1","0","139"
"Goshen",2000,"3","148","0","1","0","149"
"Goshen",2000,"4","147","0","1","1","149"
"Goshen",2000,"5","117","0","3","0","120"
"Goshen",2000,"6","174","1","5","0","180"
"Goshen",2000,"7","125","0","2","0","127"
"Goshen",2000,"8","180","0","3","1","184"
"Goshen",2000,"9","179","0","3","0","182"
"Goshen",2000,"10","190","3","0","0","193"
"Goshen",2000,"11","171","2","3","0","176"
"Goshen",2000,"12","179","0","4","4","187"
"Goshen",2000,"13","180","1","3","0","184"
"Goshen",2000,"14","183","0","4","3","190"
"Goshen",2000,"15","205","0","2","0","207"
"Goshen",2000,"16","187","1","1","1","190"
"Goshen",2000,"17","181","1","2","1","185"
"Goshen",2000,"18 to 20","659","5","7","5","676"
"Goshen",2000,"21 to 24","498","0","5","5","508"
"Goshen",2000,"25 & over","8247","16","60","20","8343"
"Goshen",2000,"Total","12368","35","116","42","12561"
"Natrona",1998,"0","792","12","10","2","816"
"Natrona",1998,"1","886","12","9","8","915"
"Natrona",1998,"2","811","12","15","2","840"
"Natrona",1998,"3","842","24","16","9","891"
"Natrona",1998,"4","863","13","10","4","890"
"Natrona",1998,"5","875","17","12","6","910"
"Natrona",1998,"6","904","14","17","0","935"
"Natrona",1998,"7","902","11","11","5","929"
"Natrona",1998,"8","968","13","10","2","993"
"Natrona",1998,"9","926","16","18","9","969"
"Natrona",1998,"10","1008","24","11","6","1049"
"Natrona",1998,"11","977","17","11","4","1009"
"Natrona",1998,"12","1017","12","15","7","1051"
"Natrona",1998,"13","1056","10","19","7","1092"
"Natrona",1998,"14","1019","15","18","4","1056"
"Natrona",1998,"15","1136","14","20","11","1181"
"Natrona",1998,"16","1058","7","9","4","1078"
"Natrona",1998,"17","1087","10","8","5","1110"
"Natrona",1998,"18 to 20","3194","56","41","21","3312"
"Natrona",1998,"21 to 24","3247","37","39","20","3343"
"Natrona",1998,"25 & over","40913","281","395","188","41777"
"Natrona",1998,"Total","64481","627","714","324","66146"
"Washakie",1992,"0","109","0","0","1","110"
"Washakie",1992,"1","107","0","2","0","109"
"Washakie",1992,"2","119","0","0","2","121"
"Washakie",1992,"3","107","0","0","0","107"
"Washakie",1992,"4","110","0","0","0","110"
"Washakie",1992,"5","120","1","3","1","125"
"Washakie",1992,"6","121","0","0","1","122"
"Washakie",1992,"7","136","0","0","0","136"
"Washakie",1992,"8","148","0","0","0","148"
"Washakie",1992,"9","171","0","0","0","171"
"Washakie",1992,"10","171","0","0","1","172"
"Washakie",1992,"11","171","0","0","0","171"
"Washakie",1992,"12","152","0","4","1","157"
"Washakie",1992,"13","156","0","2","0","158"
"Washakie",1992,"14","154","0","3","0","157"
"Washakie",1992,"15","164","0","5","0","169"
"Washakie",1992,"16","134","0","0","0","134"
"Washakie",1992,"17","134","0","0","1","135"
"Washakie",1992,"18 to 20","264","1","1","0","266"
"Washakie",1992,"21 to 24","269","0","0","0","269"
"Washakie",1992,"25 & over","5335","1","20","17","5373"
"Washakie",1992,"Total","8352","3","40","25","8420"
"Sublette",2009,"0","146","0","0","0","146"
"Sublette",2009,"1","173","5","2","1","181"
"Sublette",2009,"2","147","0","2","1","150"
"Sublette",2009,"3","124","1","2","0","127"
"Sublette",2009,"4","112","0","2","2","116"
"Sublette",2009,"5","139","0","1","0","140"
"Sublette",2009,"6","118","0","1","1","120"
"Sublette",2009,"7","133","1","1","0","135"
"Sublette",2009,"8","120","0","1","2","123"
"Sublette",2009,"9","130","0","0","1","131"
"Sublette",2009,"10","135","1","1","0","137"
"Sublette",2009,"11","127","0","3","1","131"
"Sublette",2009,"12","122","2","1","1","126"
"Sublette",2009,"13","110","0","2","0","112"
"Sublette",2009,"14","120","0","1","0","121"
"Sublette",2009,"15","127","2","3","2","134"
"Sublette",2009,"16","125","1","4","0","130"
"Sublette",2009,"17","124","1","4","0","129"
"Sublette",2009,"18 to 20","280","3","8","4","295"
"Sublette",2009,"21 to 24","418","3","4","13","438"
"Sublette",2009,"25 & over","6876","47","61","28","7012"
"Sublette",2009,"Total","9906","67","104","57","10134"
"Carbon",2002,"0","167","0","5","3","175"
"Carbon",2002,"1","176","1","5","0","182"
"Carbon",2002,"2","170","3","2","1","176"
"Carbon",2002,"3","191","3","4","2","200"
"Carbon",2002,"4","173","3","1","1","178"
"Carbon",2002,"5","177","2","4","1","184"
"Carbon",2002,"6","169","4","4","1","178"
"Carbon",2002,"7","171","1","3","1","176"
"Carbon",2002,"8","180","1","8","2","191"
"Carbon",2002,"9","175","1","5","2","183"
"Carbon",2002,"10","186","2","6","4","198"
"Carbon",2002,"11","211","2","2","1","216"
"Carbon",2002,"12","189","2","0","1","192"
"Carbon",2002,"13","201","2","3","0","206"
"Carbon",2002,"14","192","3","1","4","200"
"Carbon",2002,"15","222","2","4","4","232"
"Carbon",2002,"16","232","3","3","3","241"
"Carbon",2002,"17","242","2","6","3","253"
"Carbon",2002,"18 to 20","598","7","8","5","618"
"Carbon",2002,"21 to 24","728","9","15","7","759"
"Carbon",2002,"25 & over","10018","69","139","92","10318"
"Carbon",2002,"Total","14768","122","228","138","15256"
"Park",1998,"0","274","0","2","1","277"
"Park",1998,"1","286","0","3","0","289"
"Park",1998,"2","316","0","5","4","325"
"Park",1998,"3","297","0","0","0","297"
"Park",1998,"4","294","0","1","5","300"
"Park",1998,"5","291","1","3","3","298"
"Park",1998,"6","303","0","0","0","303"
"Park",1998,"7","327","0","1","0","328"
"Park",1998,"8","373","0","3","0","376"
"Park",1998,"9","363","0","1","0","364"
"Park",1998,"10","348","0","4","0","352"
"Park",1998,"11","388","0","0","4","392"
"Park",1998,"12","420","0","6","5","431"
"Park",1998,"13","441","0","2","2","445"
"Park",1998,"14","413","2","0","2","417"
"Park",1998,"15","480","1","1","0","482"
"Park",1998,"16","432","0","5","3","440"
"Park",1998,"17","458","0","1","0","459"
"Park",1998,"18 to 20","1345","0","15","14","1374"
"Park",1998,"21 to 24","1020","0","6","8","1034"
"Park",1998,"25 & over","16822","7","73","65","16967"
"Park",1998,"Total","25691","11","132","116","25950"
"Weston",2009,"0","88","0","3","1","92"
"Weston",2009,"1","76","1","0","1","78"
"Weston",2009,"2","66","1","1","1","69"
"Weston",2009,"3","70","2","4","0","76"
"Weston",2009,"4","87","1","2","0","90"
"Weston",2009,"5","97","2","2","0","101"
"Weston",2009,"6","94","0","3","0","97"
"Weston",2009,"7","74","1","1","1","77"
"Weston",2009,"8","87","2","4","1","94"
"Weston",2009,"9","91","0","1","0","92"
"Weston",2009,"10","70","1","0","1","72"
"Weston",2009,"11","83","0","2","0","85"
"Weston",2009,"12","89","0","2","0","91"
"Weston",2009,"13","86","2","4","0","92"
"Weston",2009,"14","67","0","1","0","68"
"Weston",2009,"15","108","0","3","0","111"
"Weston",2009,"16","85","0","3","0","88"
"Weston",2009,"17","83","1","0","0","84"
"Weston",2009,"18 to 20","234","2","6","1","243"
"Weston",2009,"21 to 24","361","4","2","1","368"
"Weston",2009,"25 & over","4995","16","70","17","5098"
"Weston",2009,"Total","7091","36","114","25","7266"
"Weston",1998,"0","55","0","2","0","57"
"Weston",1998,"1","75","0","0","0","75"
"Weston",1998,"2","71","0","5","0","76"
"Weston",1998,"3","75","0","2","0","77"
"Weston",1998,"4","77","0","1","0","78"
"Weston",1998,"5","67","0","0","0","67"
"Weston",1998,"6","80","0","0","0","80"
"Weston",1998,"7","77","0","0","0","77"
"Weston",1998,"8","80","0","0","0","80"
"Weston",1998,"9","85","0","4","0","89"
"Weston",1998,"10","94","0","5","0","99"
"Weston",1998,"11","117","0","1","0","118"
"Weston",1998,"12","104","0","0","0","104"
"Weston",1998,"13","128","0","0","0","128"
"Weston",1998,"14","107","0","0","0","107"
"Weston",1998,"15","130","0","0","0","130"
"Weston",1998,"16","121","0","0","0","121"
"Weston",1998,"17","125","0","2","0","127"
"Weston",1998,"18 to 20","266","0","15","0","281"
"Weston",1998,"21 to 24","233","0","6","0","239"
"Weston",1998,"25 & over","4502","0","24","3","4529"
"Weston",1998,"Total","6669","0","67","3","6739"
"Sweetwater",2012,"0","564","20","16","6","606"
"Sweetwater",2012,"1","634","7","12","10","663"
"Sweetwater",2012,"2","644","19","14","5","682"
"Sweetwater",2012,"3","707","17","12","10","746"
"Sweetwater",2012,"4","753","14","12","8","787"
"Sweetwater",2012,"5","721","20","14","4","759"
"Sweetwater",2012,"6","708","17","11","5","741"
"Sweetwater",2012,"7","676","11","17","5","709"
"Sweetwater",2012,"8","641","10","12","9","672"
"Sweetwater",2012,"9","646","14","18","7","685"
"Sweetwater",2012,"10","634","13","11","8","666"
"Sweetwater",2012,"11","619","11","13","8","651"
"Sweetwater",2012,"12","618","13","16","4","651"
"Sweetwater",2012,"13","618","8","8","3","637"
"Sweetwater",2012,"14","603","10","12","4","629"
"Sweetwater",2012,"15","606","12","11","3","632"
"Sweetwater",2012,"16","569","14","10","8","601"
"Sweetwater",2012,"17","562","13","8","3","586"
"Sweetwater",2012,"18 to 20","1668","46","42","27","1783"
"Sweetwater",2012,"21 to 24","2354","70","43","31","2498"
"Sweetwater",2012,"25 & over","27551","486","364","301","28702"
"Sweetwater",2012,"Total","43096","845","676","469","45086"
"Johnson",2008,"0","113","0","6","1","120"
"Johnson",2008,"1","123","1","4","1","129"
"Johnson",2008,"2","95","0","2","0","97"
"Johnson",2008,"3","119","1","3","0","123"
"Johnson",2008,"4","102","3","3","0","108"
"Johnson",2008,"5","76","0","2","1","79"
"Johnson",2008,"6","85","1","3","0","89"
"Johnson",2008,"7","99","0","2","0","101"
"Johnson",2008,"8","92","0","0","0","92"
"Johnson",2008,"9","79","0","0","0","79"
"Johnson",2008,"10","92","1","1","0","94"
"Johnson",2008,"11","109","0","1","0","110"
"Johnson",2008,"12","85","0","1","0","86"
"Johnson",2008,"13","131","0","0","1","132"
"Johnson",2008,"14","101","1","0","0","102"
"Johnson",2008,"15","132","2","1","0","135"
"Johnson",2008,"16","98","2","4","2","106"
"Johnson",2008,"17","106","1","0","0","107"
"Johnson",2008,"18 to 20","229","0","5","1","235"
"Johnson",2008,"21 to 24","293","1","8","4","306"
"Johnson",2008,"25 & over","5948","11","47","24","6030"
"Johnson",2008,"Total","8307","25","93","35","8460"
"Washakie",2004,"0","79","0","0","1","80"
"Washakie",2004,"1","98","3","2","1","104"
"Washakie",2004,"2","80","0","2","3","85"
"Washakie",2004,"3","105","1","1","0","107"
"Washakie",2004,"4","91","1","2","0","94"
"Washakie",2004,"5","101","1","2","2","106"
"Washakie",2004,"6","112","1","0","0","113"
"Washakie",2004,"7","98","0","1","2","101"
"Washakie",2004,"8","99","1","2","0","102"
"Washakie",2004,"9","88","2","1","1","92"
"Washakie",2004,"10","96","1","0","0","97"
"Washakie",2004,"11","90","0","2","0","92"
"Washakie",2004,"12","114","0","3","0","117"
"Washakie",2004,"13","110","1","1","3","115"
"Washakie",2004,"14","141","0","5","1","147"
"Washakie",2004,"15","125","1","1","3","130"
"Washakie",2004,"16","140","3","2","1","146"
"Washakie",2004,"17","148","0","3","0","151"
"Washakie",2004,"18 to 20","286","2","4","2","294"
"Washakie",2004,"21 to 24","309","1","0","4","314"
"Washakie",2004,"25 & over","5269","12","49","43","5373"
"Washakie",2004,"Total","7779","31","83","67","7960"
"Sheridan",2002,"0","267","3","8","1","279"
"Sheridan",2002,"1","265","2","7","2","276"
"Sheridan",2002,"2","328","1","9","0","338"
"Sheridan",2002,"3","229","2","2","1","234"
"Sheridan",2002,"4","292","4","7","1","304"
"Sheridan",2002,"5","295","1","5","4","305"
"Sheridan",2002,"6","262","4","7","1","274"
"Sheridan",2002,"7","291","2","8","1","302"
"Sheridan",2002,"8","329","3","4","1","337"
"Sheridan",2002,"9","366","2","6","3","377"
"Sheridan",2002,"10","317","2","11","2","332"
"Sheridan",2002,"11","328","2","9","2","341"
"Sheridan",2002,"12","364","2","9","0","375"
"Sheridan",2002,"13","383","3","9","1","396"
"Sheridan",2002,"14","395","0","14","9","418"
"Sheridan",2002,"15","400","2","10","4","416"
"Sheridan",2002,"16","416","3","13","5","437"
"Sheridan",2002,"17","478","1","10","4","493"
"Sheridan",2002,"18 to 20","1087","10","24","5","1126"
"Sheridan",2002,"21 to 24","1122","7","23","11","1163"
"Sheridan",2002,"25 & over","17972","29","211","104","18316"
"Sheridan",2002,"Total","26186","85","406","162","26839"
"Lincoln",1991,"0","200","0","3","0","203"
"Lincoln",1991,"1","230","0","3","1","234"
"Lincoln",1991,"2","234","0","1","0","235"
"Lincoln",1991,"3","229","0","0","0","229"
"Lincoln",1991,"4","228","0","0","0","228"
"Lincoln",1991,"5","248","1","0","0","249"
"Lincoln",1991,"6","268","0","0","2","270"
"Lincoln",1991,"7","290","0","0","0","290"
"Lincoln",1991,"8","301","0","3","0","304"
"Lincoln",1991,"9","323","0","2","0","325"
"Lincoln",1991,"10","303","1","4","1","309"
"Lincoln",1991,"11","344","0","1","0","345"
"Lincoln",1991,"12","288","0","2","0","290"
"Lincoln",1991,"13","294","0","5","0","299"
"Lincoln",1991,"14","282","0","1","0","283"
"Lincoln",1991,"15","271","1","1","0","273"
"Lincoln",1991,"16","275","0","2","0","277"
"Lincoln",1991,"17","241","0","1","0","242"
"Lincoln",1991,"18 to 20","416","1","7","0","424"
"Lincoln",1991,"21 to 24","371","0","0","0","371"
"Lincoln",1991,"25 & over","7248","1","23","23","7295"
"Lincoln",1991,"Total","12884","5","59","27","12975"
"Campbell",2015,"0","730","13","22","6","771"
"Campbell",2015,"1","752","11","17","8","788"
"Campbell",2015,"2","716","14","22","8","760"
"Campbell",2015,"3","767","18","18","9","812"
"Campbell",2015,"4","720","13","27","6","766"
"Campbell",2015,"5","846","13","21","11","891"
"Campbell",2015,"6","789","8","25","8","830"
"Campbell",2015,"7","865","12","15","2","894"
"Campbell",2015,"8","832","15","19","3","869"
"Campbell",2015,"9","763","9","16","4","792"
"Campbell",2015,"10","729","7","13","3","752"
"Campbell",2015,"11","756","9","12","6","783"
"Campbell",2015,"12","661","9","17","8","695"
"Campbell",2015,"13","660","10","13","2","685"
"Campbell",2015,"14","675","10","10","5","700"
"Campbell",2015,"15","719","11","25","8","763"
"Campbell",2015,"16","661","5","16","7","689"
"Campbell",2015,"17","668","9","14","3","694"
"Campbell",2015,"18 to 20","1512","25","36","6","1579"
"Campbell",2015,"21 to 24","2565","49","93","18","2725"
"Campbell",2015,"25 & over","30110","236","478","271","31095"
"Campbell",2015,"Total","47496","506","929","402","49333"
"Sheridan",1995,"0","266","0","3","0","269"
"Sheridan",1995,"1","259","1","3","4","267"
"Sheridan",1995,"2","276","0","3","0","279"
"Sheridan",1995,"3","289","0","4","0","293"
"Sheridan",1995,"4","276","0","8","3","287"
"Sheridan",1995,"5","313","2","7","2","324"
"Sheridan",1995,"6","329","0","4","3","336"
"Sheridan",1995,"7","351","0","2","0","353"
"Sheridan",1995,"8","326","0","7","0","333"
"Sheridan",1995,"9","354","0","4","0","358"
"Sheridan",1995,"10","402","0","5","1","408"
"Sheridan",1995,"11","388","0","3","2","393"
"Sheridan",1995,"12","428","4","6","0","438"
"Sheridan",1995,"13","418","2","2","0","422"
"Sheridan",1995,"14","442","0","10","7","459"
"Sheridan",1995,"15","471","1","14","1","487"
"Sheridan",1995,"16","427","0","7","5","439"
"Sheridan",1995,"17","448","0","2","6","456"
"Sheridan",1995,"18 to 20","993","11","11","0","1015"
"Sheridan",1995,"21 to 24","912","0","17","13","942"
"Sheridan",1995,"25 & over","16892","13","150","50","17105"
"Sheridan",1995,"Total","25260","34","272","97","25663"
"Weston",2001,"0","66","0","2","0","68"
"Weston",2001,"1","53","1","3","0","57"
"Weston",2001,"2","67","0","3","0","70"
"Weston",2001,"3","66","0","1","0","67"
"Weston",2001,"4","72","0","2","0","74"
"Weston",2001,"5","63","0","0","0","63"
"Weston",2001,"6","56","0","2","1","59"
"Weston",2001,"7","64","0","0","0","64"
"Weston",2001,"8","72","0","1","1","74"
"Weston",2001,"9","69","0","2","0","71"
"Weston",2001,"10","71","0","1","0","72"
"Weston",2001,"11","88","1","2","0","91"
"Weston",2001,"12","97","1","0","0","98"
"Weston",2001,"13","100","0","1","1","102"
"Weston",2001,"14","112","0","2","0","114"
"Weston",2001,"15","104","0","2","0","106"
"Weston",2001,"16","124","0","1","0","125"
"Weston",2001,"17","120","1","2","0","123"
"Weston",2001,"18 to 20","262","0","14","0","276"
"Weston",2001,"21 to 24","228","1","6","0","235"
"Weston",2001,"25 & over","4420","4","43","11","4478"
"Weston",2001,"Total","6374","9","90","14","6487"
"Teton",2000,"0","204","2","3","2","211"
"Teton",2000,"1","176","1","0","1","178"
"Teton",2000,"2","188","2","1","2","193"
"Teton",2000,"3","190","2","0","2","194"
"Teton",2000,"4","170","0","2","1","173"
"Teton",2000,"5","197","2","1","3","203"
"Teton",2000,"6","174","2","0","1","177"
"Teton",2000,"7","183","3","1","0","187"
"Teton",2000,"8","196","1","1","1","199"
"Teton",2000,"9","201","1","0","1","203"
"Teton",2000,"10","222","0","0","0","222"
"Teton",2000,"11","226","1","0","2","229"
"Teton",2000,"12","206","1","0","1","208"
"Teton",2000,"13","209","0","0","1","210"
"Teton",2000,"14","213","0","2","1","216"
"Teton",2000,"15","212","0","1","0","213"
"Teton",2000,"16","235","0","2","1","238"
"Teton",2000,"17","200","1","0","3","204"
"Teton",2000,"18 to 20","539","1","3","4","547"
"Teton",2000,"21 to 24","1237","6","7","13","1263"
"Teton",2000,"25 & over","12715","25","81","92","12913"
"Teton",2000,"Total","18093","51","105","132","18381"
"Carbon",1998,"0","169","0","0","0","169"
"Carbon",1998,"1","192","0","6","1","199"
"Carbon",1998,"2","177","4","1","0","182"
"Carbon",1998,"3","175","0","3","0","178"
"Carbon",1998,"4","182","0","1","0","183"
"Carbon",1998,"5","188","2","8","0","198"
"Carbon",1998,"6","189","0","3","0","192"
"Carbon",1998,"7","197","0","0","1","198"
"Carbon",1998,"8","209","2","9","1","221"
"Carbon",1998,"9","197","0","0","3","200"
"Carbon",1998,"10","209","1","5","4","219"
"Carbon",1998,"11","216","4","4","0","224"
"Carbon",1998,"12","237","5","0","4","246"
"Carbon",1998,"13","253","1","0","0","254"
"Carbon",1998,"14","258","1","0","3","262"
"Carbon",1998,"15","271","2","0","10","283"
"Carbon",1998,"16","279","0","0","3","282"
"Carbon",1998,"17","289","0","1","2","292"
"Carbon",1998,"18 to 20","577","8","16","4","605"
"Carbon",1998,"21 to 24","727","9","13","3","752"
"Carbon",1998,"25 & over","10201","64","109","44","10418"
"Carbon",1998,"Total","15392","103","179","83","15757"
"Carbon",2003,"0","185","0","5","2","192"
"Carbon",2003,"1","168","1","4","0","173"
"Carbon",2003,"2","163","3","2","2","170"
"Carbon",2003,"3","174","3","4","2","183"
"Carbon",2003,"4","177","3","1","1","182"
"Carbon",2003,"5","184","3","2","0","189"
"Carbon",2003,"6","186","4","3","1","194"
"Carbon",2003,"7","156","1","2","1","160"
"Carbon",2003,"8","180","2","6","2","190"
"Carbon",2003,"9","177","2","4","1","184"
"Carbon",2003,"10","180","1","6","2","189"
"Carbon",2003,"11","184","2","4","0","190"
"Carbon",2003,"12","196","1","0","2","199"
"Carbon",2003,"13","195","2","2","0","199"
"Carbon",2003,"14","198","3","1","2","204"
"Carbon",2003,"15","200","2","2","4","208"
"Carbon",2003,"16","228","3","2","4","237"
"Carbon",2003,"17","220","2","6","2","230"
"Carbon",2003,"18 to 20","583","7","7","5","602"
"Carbon",2003,"21 to 24","795","8","12","7","822"
"Carbon",2003,"25 & over","10032","76","139","96","10343"
"Carbon",2003,"Total","14761","129","214","136","15240"
"Washakie",2000,"0","90","1","0","2","93"
"Washakie",2000,"1","98","0","1","3","102"
"Washakie",2000,"2","97","0","2","1","100"
"Washakie",2000,"3","95","1","0","0","96"
"Washakie",2000,"4","92","1","0","0","93"
"Washakie",2000,"5","99","1","2","2","104"
"Washakie",2000,"6","88","2","1","1","92"
"Washakie",2000,"7","102","0","1","2","105"
"Washakie",2000,"8","133","1","1","0","135"
"Washakie",2000,"9","122","2","2","3","129"
"Washakie",2000,"10","155","0","0","0","155"
"Washakie",2000,"11","121","0","1","0","122"
"Washakie",2000,"12","129","0","1","1","131"
"Washakie",2000,"13","130","1","1","4","136"
"Washakie",2000,"14","150","0","3","1","154"
"Washakie",2000,"15","152","0","1","1","154"
"Washakie",2000,"16","182","3","3","0","188"
"Washakie",2000,"17","143","1","1","1","146"
"Washakie",2000,"18 to 20","280","2","3","1","286"
"Washakie",2000,"21 to 24","248","0","0","2","250"
"Washakie",2000,"25 & over","5402","6","33","40","5481"
"Washakie",2000,"Total","8108","22","57","65","8252"
"Fremont",2010,"0","391","7","250","5","653"
"Fremont",2010,"1","393","3","226","1","623"
"Fremont",2010,"2","376","6","238","3","623"
"Fremont",2010,"3","402","5","225","3","635"
"Fremont",2010,"4","383","3","238","6","630"
"Fremont",2010,"5","368","3","227","3","601"
"Fremont",2010,"6","355","3","217","4","579"
"Fremont",2010,"7","354","4","217","2","577"
"Fremont",2010,"8","357","5","193","2","557"
"Fremont",2010,"9","365","7","190","2","564"
"Fremont",2010,"10","343","3","170","0","516"
"Fremont",2010,"11","345","5","175","1","526"
"Fremont",2010,"12","348","6","180","3","537"
"Fremont",2010,"13","351","6","167","4","528"
"Fremont",2010,"14","342","5","175","3","525"
"Fremont",2010,"15","345","1","162","2","510"
"Fremont",2010,"16","356","4","164","4","528"
"Fremont",2010,"17","372","1","183","3","559"
"Fremont",2010,"18 to 20","1079","7","499","8","1593"
"Fremont",2010,"21 to 24","1329","12","563","5","1909"
"Fremont",2010,"25 & over","21770","95","4458","126","26449"
"Fremont",2010,"Total","30724","191","9117","190","40222"
"Weston",2015,"0","69","1","1","0","71"
"Weston",2015,"1","95","0","3","0","98"
"Weston",2015,"2","95","2","5","0","102"
"Weston",2015,"3","87","3","0","0","90"
"Weston",2015,"4","78","0","3","1","82"
"Weston",2015,"5","83","1","2","1","87"
"Weston",2015,"6","77","1","1","0","79"
"Weston",2015,"7","76","1","0","0","77"
"Weston",2015,"8","68","2","3","0","73"
"Weston",2015,"9","87","4","2","0","93"
"Weston",2015,"10","93","3","2","0","98"
"Weston",2015,"11","100","1","2","0","103"
"Weston",2015,"12","81","1","2","1","85"
"Weston",2015,"13","80","3","2","1","86"
"Weston",2015,"14","82","0","0","0","82"
"Weston",2015,"15","71","2","1","2","76"
"Weston",2015,"16","75","2","1","0","78"
"Weston",2015,"17","92","1","2","0","95"
"Weston",2015,"18 to 20","202","4","7","2","215"
"Weston",2015,"21 to 24","324","12","4","0","340"
"Weston",2015,"25 & over","4968","41","77","34","5120"
"Weston",2015,"Total","6983","85","120","42","7230"
"Johnson",2004,"0","77","1","4","0","82"
"Johnson",2004,"1","63","0","2","1","66"
"Johnson",2004,"2","68","0","2","0","70"
"Johnson",2004,"3","85","0","1","0","86"
"Johnson",2004,"4","63","1","2","1","67"
"Johnson",2004,"5","91","0","2","1","94"
"Johnson",2004,"6","76","2","2","0","80"
"Johnson",2004,"7","100","0","3","0","103"
"Johnson",2004,"8","78","2","2","0","82"
"Johnson",2004,"9","98","0","1","0","99"
"Johnson",2004,"10","89","0","2","0","91"
"Johnson",2004,"11","103","0","0","0","103"
"Johnson",2004,"12","104","0","1","0","105"
"Johnson",2004,"13","102","0","1","0","103"
"Johnson",2004,"14","117","0","2","0","119"
"Johnson",2004,"15","115","1","0","1","117"
"Johnson",2004,"16","101","0","1","1","103"
"Johnson",2004,"17","104","0","0","0","104"
"Johnson",2004,"18 to 20","249","0","3","4","256"
"Johnson",2004,"21 to 24","248","2","4","1","255"
"Johnson",2004,"25 & over","5324","7","31","7","5369"
"Johnson",2004,"Total","7455","16","66","17","7554"
"Park",2003,"0","256","1","2","1","260"
"Park",2003,"1","259","1","1","2","263"
"Park",2003,"2","253","2","6","2","263"
"Park",2003,"3","249","1","1","2","253"
"Park",2003,"4","270","1","1","3","275"
"Park",2003,"5","310","0","2","0","312"
"Park",2003,"6","277","1","1","1","280"
"Park",2003,"7","311","3","1","1","316"
"Park",2003,"8","279","2","2","1","284"
"Park",2003,"9","302","1","2","1","306"
"Park",2003,"10","321","2","4","1","328"
"Park",2003,"11","339","0","3","2","344"
"Park",2003,"12","373","2","6","6","387"
"Park",2003,"13","349","6","3","1","359"
"Park",2003,"14","376","2","2","3","383"
"Park",2003,"15","401","1","1","3","406"
"Park",2003,"16","395","0","3","3","401"
"Park",2003,"17","395","1","2","3","401"
"Park",2003,"18 to 20","1233","2","15","14","1264"
"Park",2003,"21 to 24","1154","6","6","10","1176"
"Park",2003,"25 & over","17532","18","88","89","17727"
"Park",2003,"Total","25634","53","152","149","25988"
"Big Horn",2010,"0","127","1","7","0","135"
"Big Horn",2010,"1","145","0","3","0","148"
"Big Horn",2010,"2","151","1","1","0","153"
"Big Horn",2010,"3","163","0","1","0","164"
"Big Horn",2010,"4","168","1","1","1","171"
"Big Horn",2010,"5","176","2","0","0","178"
"Big Horn",2010,"6","153","1","0","1","155"
"Big Horn",2010,"7","161","0","1","2","164"
"Big Horn",2010,"8","162","2","0","0","164"
"Big Horn",2010,"9","150","1","2","1","154"
"Big Horn",2010,"10","170","1","5","2","178"
"Big Horn",2010,"11","160","2","2","1","165"
"Big Horn",2010,"12","167","1","1","1","170"
"Big Horn",2010,"13","171","1","0","2","174"
"Big Horn",2010,"14","177","2","2","0","181"
"Big Horn",2010,"15","186","2","2","1","191"
"Big Horn",2010,"16","178","2","0","0","180"
"Big Horn",2010,"17","177","1","3","0","181"
"Big Horn",2010,"18 to 20","359","8","7","1","375"
"Big Horn",2010,"21 to 24","438","3","14","0","455"
"Big Horn",2010,"25 & over","7680","33","95","29","7837"
"Big Horn",2010,"Total","11419","65","147","42","11673"
"Platte",2004,"0","97","1","1","0","99"
"Platte",2004,"1","91","0","1","0","92"
"Platte",2004,"2","95","1","0","0","96"
"Platte",2004,"3","85","1","1","1","88"
"Platte",2004,"4","90","1","0","0","91"
"Platte",2004,"5","95","3","0","1","99"
"Platte",2004,"6","104","0","2","0","106"
"Platte",2004,"7","94","1","0","1","96"
"Platte",2004,"8","93","0","0","0","93"
"Platte",2004,"9","105","1","0","1","107"
"Platte",2004,"10","121","0","2","1","124"
"Platte",2004,"11","117","1","1","0","119"
"Platte",2004,"12","143","1","1","0","145"
"Platte",2004,"13","131","0","0","0","131"
"Platte",2004,"14","161","0","1","1","163"
"Platte",2004,"15","133","1","1","0","135"
"Platte",2004,"16","146","0","1","2","149"
"Platte",2004,"17","123","0","3","0","126"
"Platte",2004,"18 to 20","280","2","4","3","289"
"Platte",2004,"21 to 24","294","0","3","1","298"
"Platte",2004,"25 & over","6030","10","30","14","6084"
"Platte",2004,"Total","8628","24","52","26","8730"
"Fremont",2015,"0","376","8","168","4","556"
"Fremont",2015,"1","355","9","240","1","605"
"Fremont",2015,"2","329","7","243","3","582"
"Fremont",2015,"3","340","5","250","2","597"
"Fremont",2015,"4","350","12","256","6","624"
"Fremont",2015,"5","374","5","222","4","605"
"Fremont",2015,"6","389","6","211","2","608"
"Fremont",2015,"7","378","4","231","3","616"
"Fremont",2015,"8","404","7","198","4","613"
"Fremont",2015,"9","364","6","235","1","606"
"Fremont",2015,"10","339","9","218","4","570"
"Fremont",2015,"11","338","5","216","6","565"
"Fremont",2015,"12","349","2","199","3","553"
"Fremont",2015,"13","339","8","200","3","550"
"Fremont",2015,"14","329","7","180","3","519"
"Fremont",2015,"15","336","6","168","0","510"
"Fremont",2015,"16","348","6","160","1","515"
"Fremont",2015,"17","350","6","184","4","544"
"Fremont",2015,"18 to 20","920","10","426","8","1364"
"Fremont",2015,"21 to 24","1272","10","578","10","1870"
"Fremont",2015,"25 & over","21925","169","4537","152","26783"
"Fremont",2015,"Total","30504","307","9320","224","40355"
"Uinta",2016,"0","285","8","5","2","300"
"Uinta",2016,"1","281","10","10","1","302"
"Uinta",2016,"2","337","8","10","1","356"
"Uinta",2016,"3","322","8","7","8","345"
"Uinta",2016,"4","319","7","3","2","331"
"Uinta",2016,"5","312","13","7","4","336"
"Uinta",2016,"6","346","5","6","6","363"
"Uinta",2016,"7","331","3","4","3","341"
"Uinta",2016,"8","356","4","3","2","365"
"Uinta",2016,"9","339","6","4","3","352"
"Uinta",2016,"10","351","5","3","7","366"
"Uinta",2016,"11","324","3","6","2","335"
"Uinta",2016,"12","351","2","7","2","362"
"Uinta",2016,"13","320","2","2","4","328"
"Uinta",2016,"14","333","3","4","3","343"
"Uinta",2016,"15","309","5","4","1","319"
"Uinta",2016,"16","320","3","5","1","329"
"Uinta",2016,"17","316","3","2","4","325"
"Uinta",2016,"18 to 20","643","8","13","8","672"
"Uinta",2016,"21 to 24","843","19","16","6","884"
"Uinta",2016,"25 & over","12739","109","169","102","13119"
"Uinta",2016,"Total","20077","234","290","172","20773"
"Natrona",2002,"0","891","25","28","6","950"
"Natrona",2002,"1","824","36","31","8","899"
"Natrona",2002,"2","785","33","20","6","844"
"Natrona",2002,"3","888","26","12","14","940"
"Natrona",2002,"4","779","25","21","6","831"
"Natrona",2002,"5","854","27","17","5","903"
"Natrona",2002,"6","869","14","15","9","907"
"Natrona",2002,"7","917","17","14","8","956"
"Natrona",2002,"8","888","15","18","1","922"
"Natrona",2002,"9","879","15","18","7","919"
"Natrona",2002,"10","947","15","17","6","985"
"Natrona",2002,"11","906","14","14","6","940"
"Natrona",2002,"12","1052","18","18","4","1092"
"Natrona",2002,"13","932","12","15","5","964"
"Natrona",2002,"14","954","14","19","8","995"
"Natrona",2002,"15","977","14","15","9","1015"
"Natrona",2002,"16","1014","10","29","3","1056"
"Natrona",2002,"17","1102","10","19","10","1141"
"Natrona",2002,"18 to 20","2868","57","46","26","2997"
"Natrona",2002,"21 to 24","3741","43","57","33","3874"
"Natrona",2002,"25 & over","42315","370","491","248","43424"
"Natrona",2002,"Total","65382","810","934","428","67554"
"Crook",1993,"0","77","0","0","0","77"
"Crook",1993,"1","71","0","1","0","72"
"Crook",1993,"2","76","0","0","0","76"
"Crook",1993,"3","71","0","0","0","71"
"Crook",1993,"4","82","0","0","0","82"
"Crook",1993,"5","74","0","1","0","75"
"Crook",1993,"6","91","0","0","0","91"
"Crook",1993,"7","97","0","0","0","97"
"Crook",1993,"8","97","0","0","0","97"
"Crook",1993,"9","99","0","0","0","99"
"Crook",1993,"10","107","0","3","0","110"
"Crook",1993,"11","111","0","0","0","111"
"Crook",1993,"12","110","0","0","0","110"
"Crook",1993,"13","114","0","0","0","114"
"Crook",1993,"14","101","0","0","0","101"
"Crook",1993,"15","98","0","2","0","100"
"Crook",1993,"16","97","0","0","0","97"
"Crook",1993,"17","87","0","0","0","87"
"Crook",1993,"18 to 20","172","0","2","0","174"
"Crook",1993,"21 to 24","177","0","0","0","177"
"Crook",1993,"25 & over","3401","0","16","0","3417"
"Crook",1993,"Total","5410","0","25","0","5435"
"Platte",2011,"0","80","1","1","0","82"
"Platte",2011,"1","70","1","0","2","73"
"Platte",2011,"2","86","0","2","0","88"
"Platte",2011,"3","87","1","2","0","90"
"Platte",2011,"4","90","1","1","2","94"
"Platte",2011,"5","92","1","0","1","94"
"Platte",2011,"6","92","2","0","0","94"
"Platte",2011,"7","89","2","0","0","91"
"Platte",2011,"8","93","1","0","0","94"
"Platte",2011,"9","108","1","2","0","111"
"Platte",2011,"10","89","0","0","0","89"
"Platte",2011,"11","95","0","2","3","100"
"Platte",2011,"12","97","0","0","0","97"
"Platte",2011,"13","100","2","0","0","102"
"Platte",2011,"14","103","2","0","1","106"
"Platte",2011,"15","97","0","2","2","101"
"Platte",2011,"16","115","2","1","1","119"
"Platte",2011,"17","118","0","1","2","121"
"Platte",2011,"18 to 20","243","3","4","7","257"
"Platte",2011,"21 to 24","294","4","2","3","303"
"Platte",2011,"25 & over","6305","29","42","21","6397"
"Platte",2011,"Total","8543","53","62","45","8703"
"Crook",2005,"0","77","1","0","0","78"
"Crook",2005,"1","70","0","1","0","71"
"Crook",2005,"2","60","2","0","0","62"
"Crook",2005,"3","69","0","1","1","71"
"Crook",2005,"4","65","0","1","1","67"
"Crook",2005,"5","81","2","1","0","84"
"Crook",2005,"6","77","0","1","0","78"
"Crook",2005,"7","68","2","0","0","70"
"Crook",2005,"8","64","0","1","0","65"
"Crook",2005,"9","79","1","1","0","81"
"Crook",2005,"10","63","1","0","0","64"
"Crook",2005,"11","78","0","3","0","81"
"Crook",2005,"12","100","0","0","0","100"
"Crook",2005,"13","86","0","1","0","87"
"Crook",2005,"14","103","0","1","0","104"
"Crook",2005,"15","106","0","3","0","109"
"Crook",2005,"16","96","0","0","0","96"
"Crook",2005,"17","101","0","1","0","102"
"Crook",2005,"18 to 20","245","0","1","0","246"
"Crook",2005,"21 to 24","244","0","5","0","249"
"Crook",2005,"25 & over","4170","8","29","4","4211"
"Crook",2005,"Total","6102","17","51","6","6176"
"Goshen",2016,"0","137","3","3","4","147"
"Goshen",2016,"1","134","4","4","3","145"
"Goshen",2016,"2","145","7","6","1","159"
"Goshen",2016,"3","120","3","14","0","137"
"Goshen",2016,"4","125","2","7","0","134"
"Goshen",2016,"5","132","3","0","1","136"
"Goshen",2016,"6","141","3","5","2","151"
"Goshen",2016,"7","159","2","4","2","167"
"Goshen",2016,"8","138","7","0","2","147"
"Goshen",2016,"9","174","3","3","0","180"
"Goshen",2016,"10","128","2","2","1","133"
"Goshen",2016,"11","130","0","2","0","132"
"Goshen",2016,"12","161","1","0","1","163"
"Goshen",2016,"13","146","2","4","3","155"
"Goshen",2016,"14","153","0","2","1","156"
"Goshen",2016,"15","146","4","2","2","154"
"Goshen",2016,"16","174","2","2","2","180"
"Goshen",2016,"17","152","1","0","1","154"
"Goshen",2016,"18 to 20","559","15","5","6","585"
"Goshen",2016,"21 to 24","616","16","13","8","653"
"Goshen",2016,"25 & over","9166","108","96","52","9422"
"Goshen",2016,"Total","12936","188","174","92","13390"
"Platte",1995,"0","97","0","0","0","97"
"Platte",1995,"1","98","0","1","0","99"
"Platte",1995,"2","90","0","0","0","90"
"Platte",1995,"3","96","0","0","0","96"
"Platte",1995,"4","104","0","1","0","105"
"Platte",1995,"5","129","1","1","1","132"
"Platte",1995,"6","106","0","0","0","106"
"Platte",1995,"7","118","0","0","0","118"
"Platte",1995,"8","128","0","0","0","128"
"Platte",1995,"9","119","0","0","0","119"
"Platte",1995,"10","148","1","0","0","149"
"Platte",1995,"11","147","0","1","0","148"
"Platte",1995,"12","154","0","0","0","154"
"Platte",1995,"13","152","0","0","0","152"
"Platte",1995,"14","144","0","0","0","144"
"Platte",1995,"15","164","0","0","0","164"
"Platte",1995,"16","149","0","0","0","149"
"Platte",1995,"17","149","0","0","0","149"
"Platte",1995,"18 to 20","263","0","0","2","265"
"Platte",1995,"21 to 24","288","0","0","0","288"
"Platte",1995,"25 & over","5591","0","9","1","5601"
"Platte",1995,"Total","8434","2","13","4","8453"
"Crook",2002,"0","68","0","1","0","69"
"Crook",2002,"1","58","0","2","0","60"
"Crook",2002,"2","66","0","1","0","67"
"Crook",2002,"3","63","0","1","0","64"
"Crook",2002,"4","54","0","2","1","57"
"Crook",2002,"5","58","0","2","0","60"
"Crook",2002,"6","80","0","2","0","82"
"Crook",2002,"7","55","0","0","0","55"
"Crook",2002,"8","69","0","2","0","71"
"Crook",2002,"9","76","0","0","0","76"
"Crook",2002,"10","79","1","0","0","80"
"Crook",2002,"11","91","0","3","0","94"
"Crook",2002,"12","85","0","1","0","86"
"Crook",2002,"13","88","0","0","0","88"
"Crook",2002,"14","99","0","1","0","100"
"Crook",2002,"15","118","0","4","0","122"
"Crook",2002,"16","118","0","1","0","119"
"Crook",2002,"17","124","0","1","0","125"
"Crook",2002,"18 to 20","249","1","2","0","252"
"Crook",2002,"21 to 24","203","0","3","0","206"
"Crook",2002,"25 & over","3956","1","33","3","3993"
"Crook",2002,"Total","5857","3","62","4","5926"
"Goshen",2001,"0","134","1","3","1","139"
"Goshen",2001,"1","144","2","3","0","149"
"Goshen",2001,"2","139","2","1","0","142"
"Goshen",2001,"3","151","0","2","0","153"
"Goshen",2001,"4","134","0","0","1","135"
"Goshen",2001,"5","142","0","2","0","144"
"Goshen",2001,"6","122","1","4","0","127"
"Goshen",2001,"7","173","0","2","0","175"
"Goshen",2001,"8","130","0","2","1","133"
"Goshen",2001,"9","176","0","3","0","179"
"Goshen",2001,"10","174","3","0","0","177"
"Goshen",2001,"11","185","2","3","0","190"
"Goshen",2001,"12","167","0","4","4","175"
"Goshen",2001,"13","179","1","3","0","183"
"Goshen",2001,"14","180","0","4","4","188"
"Goshen",2001,"15","179","0","2","0","181"
"Goshen",2001,"16","200","1","2","1","204"
"Goshen",2001,"17","176","1","2","1","180"
"Goshen",2001,"18 to 20","616","5","7","5","633"
"Goshen",2001,"21 to 24","513","1","4","5","523"
"Goshen",2001,"25 & over","8271","14","61","19","8365"
"Goshen",2001,"Total","12285","34","114","42","12475"
"Niobrara",1997,"0","19","0","0","0","19"
"Niobrara",1997,"1","26","0","0","0","26"
"Niobrara",1997,"2","23","0","0","0","23"
"Niobrara",1997,"3","32","0","0","0","32"
"Niobrara",1997,"4","23","0","0","0","23"
"Niobrara",1997,"5","29","0","0","0","29"
"Niobrara",1997,"6","22","0","0","0","22"
"Niobrara",1997,"7","39","0","0","0","39"
"Niobrara",1997,"8","30","0","0","0","30"
"Niobrara",1997,"9","31","0","0","0","31"
"Niobrara",1997,"10","33","0","0","0","33"
"Niobrara",1997,"11","38","0","0","0","38"
"Niobrara",1997,"12","34","0","0","0","34"
"Niobrara",1997,"13","36","0","0","0","36"
"Niobrara",1997,"14","40","0","0","0","40"
"Niobrara",1997,"15","43","0","0","0","43"
"Niobrara",1997,"16","36","0","0","0","36"
"Niobrara",1997,"17","43","0","0","0","43"
"Niobrara",1997,"18 to 20","79","1","0","0","80"
"Niobrara",1997,"21 to 24","71","0","0","0","71"
"Niobrara",1997,"25 & over","1749","1","2","0","1752"
"Niobrara",1997,"Total","2476","2","2","0","2480"
"Uinta",2010,"0","328","4","8","4","344"
"Uinta",2010,"1","340","3","5","3","351"
"Uinta",2010,"2","359","3","2","1","365"
"Uinta",2010,"3","355","2","2","0","359"
"Uinta",2010,"4","336","2","2","3","343"
"Uinta",2010,"5","344","3","5","4","356"
"Uinta",2010,"6","366","3","8","2","379"
"Uinta",2010,"7","342","3","3","1","349"
"Uinta",2010,"8","362","7","3","3","375"
"Uinta",2010,"9","335","5","2","2","344"
"Uinta",2010,"10","350","6","3","2","361"
"Uinta",2010,"11","340","4","4","5","353"
"Uinta",2010,"12","355","3","7","2","367"
"Uinta",2010,"13","342","1","3","1","347"
"Uinta",2010,"14","322","1","4","4","331"
"Uinta",2010,"15","315","5","4","0","324"
"Uinta",2010,"16","354","3","7","3","367"
"Uinta",2010,"17","333","6","4","2","345"
"Uinta",2010,"18 to 20","707","11","18","4","740"
"Uinta",2010,"21 to 24","850","1","11","6","868"
"Uinta",2010,"25 & over","12861","40","157","76","13134"
"Uinta",2010,"Total","20596","116","262","128","21102"
"Albany",2008,"0","373","8","7","6","394"
"Albany",2008,"1","342","13","5","10","370"
"Albany",2008,"2","346","17","5","5","373"
"Albany",2008,"3","329","13","7","12","361"
"Albany",2008,"4","271","12","8","10","301"
"Albany",2008,"5","278","7","5","11","301"
"Albany",2008,"6","269","7","5","11","292"
"Albany",2008,"7","293","5","5","8","311"
"Albany",2008,"8","270","9","7","9","295"
"Albany",2008,"9","245","5","2","15","267"
"Albany",2008,"10","282","10","9","5","306"
"Albany",2008,"11","270","7","3","8","288"
"Albany",2008,"12","264","7","3","9","283"
"Albany",2008,"13","286","5","1","9","301"
"Albany",2008,"14","238","5","4","8","255"
"Albany",2008,"15","324","5","4","6","339"
"Albany",2008,"16","299","5","4","3","311"
"Albany",2008,"17","290","12","8","8","318"
"Albany",2008,"18 to 20","4431","78","36","94","4639"
"Albany",2008,"21 to 24","5606","91","60","207","5964"
"Albany",2008,"25 & over","17463","198","188","525","18374"
"Albany",2008,"Total","32769","519","376","979","34643"
"Lincoln",2015,"0","236","2","5","4","247"
"Lincoln",2015,"1","253","3","4","1","261"
"Lincoln",2015,"2","251","3","7","1","262"
"Lincoln",2015,"3","268","1","7","3","279"
"Lincoln",2015,"4","259","2","2","1","264"
"Lincoln",2015,"5","272","2","3","3","280"
"Lincoln",2015,"6","299","1","2","2","304"
"Lincoln",2015,"7","316","2","4","1","323"
"Lincoln",2015,"8","306","4","1","1","312"
"Lincoln",2015,"9","306","2","1","1","310"
"Lincoln",2015,"10","294","2","5","3","304"
"Lincoln",2015,"11","283","3","5","1","292"
"Lincoln",2015,"12","280","2","4","1","287"
"Lincoln",2015,"13","269","5","2","0","276"
"Lincoln",2015,"14","269","2","3","0","274"
"Lincoln",2015,"15","276","5","2","1","284"
"Lincoln",2015,"16","276","4","3","0","283"
"Lincoln",2015,"17","276","1","1","2","280"
"Lincoln",2015,"18 to 20","553","4","11","5","573"
"Lincoln",2015,"21 to 24","653","6","13","1","673"
"Lincoln",2015,"25 & over","12107","96","112","74","12389"
"Lincoln",2015,"Total","18302","152","197","106","18757"
"Converse",1997,"0","157","0","0","0","157"
"Converse",1997,"1","140","1","4","0","145"
"Converse",1997,"2","144","3","0","0","147"
"Converse",1997,"3","167","0","0","0","167"
"Converse",1997,"4","173","0","4","0","177"
"Converse",1997,"5","184","2","3","1","190"
"Converse",1997,"6","160","0","0","0","160"
"Converse",1997,"7","195","3","3","0","201"
"Converse",1997,"8","192","0","0","0","192"
"Converse",1997,"9","203","0","4","1","208"
"Converse",1997,"10","192","0","0","2","194"
"Converse",1997,"11","201","0","3","0","204"
"Converse",1997,"12","223","0","4","0","227"
"Converse",1997,"13","238","0","0","0","238"
"Converse",1997,"14","252","5","6","1","264"
"Converse",1997,"15","241","1","0","3","245"
"Converse",1997,"16","229","0","4","0","233"
"Converse",1997,"17","269","0","3","0","272"
"Converse",1997,"18 to 20","400","0","6","0","406"
"Converse",1997,"21 to 24","431","0","3","0","434"
"Converse",1997,"25 & over","7481","3","56","10","7550"
"Converse",1997,"Total","11872","18","103","18","12011"
"Lincoln",1992,"0","197","0","3","0","200"
"Lincoln",1992,"1","217","0","3","1","221"
"Lincoln",1992,"2","234","0","1","0","235"
"Lincoln",1992,"3","225","0","0","0","225"
"Lincoln",1992,"4","219","0","0","0","219"
"Lincoln",1992,"5","234","1","0","0","235"
"Lincoln",1992,"6","255","0","0","1","256"
"Lincoln",1992,"7","289","0","0","0","289"
"Lincoln",1992,"8","286","0","3","0","289"
"Lincoln",1992,"9","320","0","2","0","322"
"Lincoln",1992,"10","300","1","4","2","307"
"Lincoln",1992,"11","329","0","1","0","330"
"Lincoln",1992,"12","308","0","2","0","310"
"Lincoln",1992,"13","305","0","5","0","310"
"Lincoln",1992,"14","287","0","1","0","288"
"Lincoln",1992,"15","288","2","4","0","294"
"Lincoln",1992,"16","273","0","1","0","274"
"Lincoln",1992,"17","259","0","0","0","259"
"Lincoln",1992,"18 to 20","433","1","5","0","439"
"Lincoln",1992,"21 to 24","388","0","0","0","388"
"Lincoln",1992,"25 & over","7387","1","23","23","7434"
"Lincoln",1992,"Total","13033","6","58","27","13124"
"Johnson",1999,"0","62","0","1","0","63"
"Johnson",1999,"1","73","0","0","0","73"
"Johnson",1999,"2","71","0","0","0","71"
"Johnson",1999,"3","78","0","0","0","78"
"Johnson",1999,"4","74","0","0","0","74"
"Johnson",1999,"5","81","0","1","0","82"
"Johnson",1999,"6","84","0","4","0","88"
"Johnson",1999,"7","99","0","0","0","99"
"Johnson",1999,"8","92","0","3","0","95"
"Johnson",1999,"9","100","0","3","0","103"
"Johnson",1999,"10","105","0","2","0","107"
"Johnson",1999,"11","100","0","0","0","100"
"Johnson",1999,"12","98","0","0","0","98"
"Johnson",1999,"13","90","0","1","0","91"
"Johnson",1999,"14","119","0","4","0","123"
"Johnson",1999,"15","105","0","1","1","107"
"Johnson",1999,"16","117","0","0","0","117"
"Johnson",1999,"17","139","0","0","0","139"
"Johnson",1999,"18 to 20","207","0","0","0","207"
"Johnson",1999,"21 to 24","188","0","0","0","188"
"Johnson",1999,"25 & over","4835","0","20","0","4855"
"Johnson",1999,"Total","6917","0","40","1","6958"
"Big Horn",1992,"0","146","0","0","0","146"
"Big Horn",1992,"1","144","0","3","0","147"
"Big Horn",1992,"2","170","0","0","0","170"
"Big Horn",1992,"3","155","0","0","0","155"
"Big Horn",1992,"4","150","0","2","0","152"
"Big Horn",1992,"5","151","0","4","1","156"
"Big Horn",1992,"6","171","0","0","0","171"
"Big Horn",1992,"7","183","0","0","0","183"
"Big Horn",1992,"8","178","0","0","0","178"
"Big Horn",1992,"9","209","0","0","0","209"
"Big Horn",1992,"10","200","0","3","1","204"
"Big Horn",1992,"11","186","0","1","0","187"
"Big Horn",1992,"12","214","0","1","0","215"
"Big Horn",1992,"13","193","0","0","0","193"
"Big Horn",1992,"14","201","0","0","1","202"
"Big Horn",1992,"15","184","0","2","0","186"
"Big Horn",1992,"16","189","0","0","0","189"
"Big Horn",1992,"17","197","0","2","2","201"
"Big Horn",1992,"18 to 20","335","0","5","0","340"
"Big Horn",1992,"21 to 24","365","0","0","0","365"
"Big Horn",1992,"25 & over","6721","0","28","10","6759"
"Big Horn",1992,"Total","10642","0","51","15","10708"
"Albany",2005,"0","358","7","6","13","384"
"Albany",2005,"1","336","16","4","5","361"
"Albany",2005,"2","338","15","4","7","364"
"Albany",2005,"3","315","12","6","8","341"
"Albany",2005,"4","297","10","6","10","323"
"Albany",2005,"5","256","8","3","5","272"
"Albany",2005,"6","237","7","2","9","255"
"Albany",2005,"7","288","8","6","10","312"
"Albany",2005,"8","286","6","5","11","308"
"Albany",2005,"9","279","4","3","9","295"
"Albany",2005,"10","275","11","9","3","298"
"Albany",2005,"11","245","9","3","5","262"
"Albany",2005,"12","298","10","3","9","320"
"Albany",2005,"13","281","5","3","4","293"
"Albany",2005,"14","271","5","5","6","287"
"Albany",2005,"15","325","6","4","4","339"
"Albany",2005,"16","280","4","6","3","293"
"Albany",2005,"17","287","9","7","6","309"
"Albany",2005,"18 to 20","4330","64","38","76","4508"
"Albany",2005,"21 to 24","5991","93","65","185","6334"
"Albany",2005,"25 & over","16374","184","189","426","17173"
"Albany",2005,"Total","31947","493","377","814","33631"
"Converse",2001,"0","126","0","0","1","127"
"Converse",2001,"1","148","2","3","0","153"
"Converse",2001,"2","135","1","0","0","136"
"Converse",2001,"3","138","0","3","0","141"
"Converse",2001,"4","171","1","4","0","176"
"Converse",2001,"5","165","2","2","0","169"
"Converse",2001,"6","168","0","1","0","169"
"Converse",2001,"7","146","2","4","1","153"
"Converse",2001,"8","170","1","1","0","172"
"Converse",2001,"9","200","2","4","1","207"
"Converse",2001,"10","193","4","4","2","203"
"Converse",2001,"11","190","1","3","0","194"
"Converse",2001,"12","190","3","4","0","197"
"Converse",2001,"13","201","0","1","2","204"
"Converse",2001,"14","227","4","3","1","235"
"Converse",2001,"15","217","0","0","0","217"
"Converse",2001,"16","228","0","2","0","230"
"Converse",2001,"17","210","1","3","2","216"
"Converse",2001,"18 to 20","450","1","6","3","460"
"Converse",2001,"21 to 24","427","0","5","1","433"
"Converse",2001,"25 & over","7707","8","70","19","7804"
"Converse",2001,"Total","11807","33","123","33","11996"
"Johnson",2012,"0","87","2","2","1","92"
"Johnson",2012,"1","113","2","8","0","123"
"Johnson",2012,"2","87","0","10","3","100"
"Johnson",2012,"3","109","1","5","2","117"
"Johnson",2012,"4","112","4","5","4","125"
"Johnson",2012,"5","115","1","3","1","120"
"Johnson",2012,"6","113","3","5","0","121"
"Johnson",2012,"7","114","2","2","1","119"
"Johnson",2012,"8","103","2","3","0","108"
"Johnson",2012,"9","83","1","3","0","87"
"Johnson",2012,"10","97","1","1","0","99"
"Johnson",2012,"11","82","0","0","0","82"
"Johnson",2012,"12","100","2","2","0","104"
"Johnson",2012,"13","84","0","1","0","85"
"Johnson",2012,"14","99","0","1","0","100"
"Johnson",2012,"15","104","1","0","1","106"
"Johnson",2012,"16","94","0","0","0","94"
"Johnson",2012,"17","121","4","1","1","127"
"Johnson",2012,"18 to 20","233","17","6","3","259"
"Johnson",2012,"21 to 24","274","10","7","4","295"
"Johnson",2012,"25 & over","5980","68","54","43","6145"
"Johnson",2012,"Total","8304","121","119","64","8608"
"Niobrara",2007,"0","19","1","0","0","20"
"Niobrara",2007,"1","23","0","0","0","23"
"Niobrara",2007,"2","12","0","0","0","12"
"Niobrara",2007,"3","12","0","0","0","12"
"Niobrara",2007,"4","25","0","1","0","26"
"Niobrara",2007,"5","20","0","0","0","20"
"Niobrara",2007,"6","27","0","0","0","27"
"Niobrara",2007,"7","22","0","0","0","22"
"Niobrara",2007,"8","22","0","0","0","22"
"Niobrara",2007,"9","36","0","0","0","36"
"Niobrara",2007,"10","31","1","0","0","32"
"Niobrara",2007,"11","23","0","0","0","23"
"Niobrara",2007,"12","21","1","0","0","22"
"Niobrara",2007,"13","26","0","0","0","26"
"Niobrara",2007,"14","28","0","0","1","29"
"Niobrara",2007,"15","30","0","0","0","30"
"Niobrara",2007,"16","38","0","0","0","38"
"Niobrara",2007,"17","36","0","0","1","37"
"Niobrara",2007,"18 to 20","52","0","0","0","52"
"Niobrara",2007,"21 to 24","100","1","2","0","103"
"Niobrara",2007,"25 & over","1764","8","17","6","1795"
"Niobrara",2007,"Total","2367","12","20","8","2407"
"Carbon",2008,"0","226","4","5","4","239"
"Carbon",2008,"1","211","4","2","0","217"
"Carbon",2008,"2","201","1","0","1","203"
"Carbon",2008,"3","225","4","2","2","233"
"Carbon",2008,"4","183","5","0","3","191"
"Carbon",2008,"5","193","5","2","3","203"
"Carbon",2008,"6","183","4","1","1","189"
"Carbon",2008,"7","171","4","2","0","177"
"Carbon",2008,"8","174","1","4","2","181"
"Carbon",2008,"9","217","2","5","2","226"
"Carbon",2008,"10","220","2","4","0","226"
"Carbon",2008,"11","180","2","6","1","189"
"Carbon",2008,"12","168","0","2","1","171"
"Carbon",2008,"13","200","2","2","2","206"
"Carbon",2008,"14","184","0","4","2","190"
"Carbon",2008,"15","196","0","6","2","204"
"Carbon",2008,"16","193","3","2","1","199"
"Carbon",2008,"17","203","0","4","2","209"
"Carbon",2008,"18 to 20","458","6","6","3","473"
"Carbon",2008,"21 to 24","766","8","13","10","797"
"Carbon",2008,"25 & over","10415","90","137","93","10735"
"Carbon",2008,"Total","15167","147","209","135","15658"
"Niobrara",2011,"0","18","0","0","0","18"
"Niobrara",2011,"1","21","2","0","0","23"
"Niobrara",2011,"2","23","0","0","0","23"
"Niobrara",2011,"3","16","0","0","0","16"
"Niobrara",2011,"4","19","0","0","0","19"
"Niobrara",2011,"5","14","0","1","0","15"
"Niobrara",2011,"6","18","0","0","0","18"
"Niobrara",2011,"7","20","0","0","0","20"
"Niobrara",2011,"8","37","0","0","0","37"
"Niobrara",2011,"9","22","0","0","0","22"
"Niobrara",2011,"10","37","0","0","0","37"
"Niobrara",2011,"11","25","1","0","0","26"
"Niobrara",2011,"12","33","0","0","0","33"
"Niobrara",2011,"13","26","2","0","0","28"
"Niobrara",2011,"14","33","1","0","0","34"
"Niobrara",2011,"15","28","0","0","1","29"
"Niobrara",2011,"16","25","1","0","0","26"
"Niobrara",2011,"17","28","1","0","0","29"
"Niobrara",2011,"18 to 20","68","1","0","1","70"
"Niobrara",2011,"21 to 24","88","3","3","0","94"
"Niobrara",2011,"25 & over","1830","13","20","7","1870"
"Niobrara",2011,"Total","2429","25","24","9","2487"
"Platte",2005,"0","89","2","0","0","91"
"Platte",2005,"1","88","0","2","0","90"
"Platte",2005,"2","86","2","0","0","88"
"Platte",2005,"3","91","1","1","2","95"
"Platte",2005,"4","77","2","0","1","80"
"Platte",2005,"5","94","1","0","0","95"
"Platte",2005,"6","111","1","0","0","112"
"Platte",2005,"7","105","1","0","0","106"
"Platte",2005,"8","81","1","0","0","82"
"Platte",2005,"9","88","0","0","1","89"
"Platte",2005,"10","117","0","1","1","119"
"Platte",2005,"11","97","1","0","0","98"
"Platte",2005,"12","130","1","1","0","132"
"Platte",2005,"13","140","1","0","0","141"
"Platte",2005,"14","118","0","1","1","120"
"Platte",2005,"15","166","3","1","0","170"
"Platte",2005,"16","140","0","2","2","144"
"Platte",2005,"17","137","0","3","1","141"
"Platte",2005,"18 to 20","262","2","3","3","270"
"Platte",2005,"21 to 24","275","1","3","1","280"
"Platte",2005,"25 & over","6082","17","25","14","6138"
"Platte",2005,"Total","8574","37","43","27","8681"
"Uinta",2007,"0","342","3","17","1","363"
"Uinta",2007,"1","320","2","2","2","326"
"Uinta",2007,"2","289","2","2","1","294"
"Uinta",2007,"3","347","2","1","1","351"
"Uinta",2007,"4","329","3","2","5","339"
"Uinta",2007,"5","345","3","4","9","361"
"Uinta",2007,"6","312","2","6","0","320"
"Uinta",2007,"7","319","2","8","1","330"
"Uinta",2007,"8","351","5","3","3","362"
"Uinta",2007,"9","290","5","0","2","297"
"Uinta",2007,"10","319","3","3","3","328"
"Uinta",2007,"11","326","4","6","4","340"
"Uinta",2007,"12","349","2","5","0","356"
"Uinta",2007,"13","331","1","3","0","335"
"Uinta",2007,"14","302","2","6","3","313"
"Uinta",2007,"15","302","3","5","0","310"
"Uinta",2007,"16","360","3","6","3","372"
"Uinta",2007,"17","358","3","6","1","368"
"Uinta",2007,"18 to 20","750","7","21","3","781"
"Uinta",2007,"21 to 24","917","1","8","3","929"
"Uinta",2007,"25 & over","12165","39","130","62","12396"
"Uinta",2007,"Total","19723","97","244","107","20171"
"Hot Springs",2008,"0","51","0","1","0","52"
"Hot Springs",2008,"1","63","1","3","0","67"
"Hot Springs",2008,"2","31","1","1","0","33"
"Hot Springs",2008,"3","42","1","1","0","44"
"Hot Springs",2008,"4","38","1","0","0","39"
"Hot Springs",2008,"5","44","0","2","0","46"
"Hot Springs",2008,"6","47","1","0","0","48"
"Hot Springs",2008,"7","42","1","0","1","44"
"Hot Springs",2008,"8","53","1","1","0","55"
"Hot Springs",2008,"9","66","1","2","1","70"
"Hot Springs",2008,"10","47","0","1","0","48"
"Hot Springs",2008,"11","47","1","1","0","49"
"Hot Springs",2008,"12","76","0","0","1","77"
"Hot Springs",2008,"13","51","1","2","1","55"
"Hot Springs",2008,"14","48","2","0","1","51"
"Hot Springs",2008,"15","54","0","2","1","57"
"Hot Springs",2008,"16","42","1","2","0","45"
"Hot Springs",2008,"17","53","1","3","1","58"
"Hot Springs",2008,"18 to 20","139","0","5","1","145"
"Hot Springs",2008,"21 to 24","177","3","9","3","192"
"Hot Springs",2008,"25 & over","3368","7","38","10","3423"
"Hot Springs",2008,"Total","4579","24","74","21","4698"
"Natrona",2016,"0","1102","34","24","24","1184"
"Natrona",2016,"1","1053","41","13","10","1117"
"Natrona",2016,"2","1096","37","36","20","1189"
"Natrona",2016,"3","1055","34","33","14","1136"
"Natrona",2016,"4","987","35","20","20","1062"
"Natrona",2016,"5","1026","43","23","28","1120"
"Natrona",2016,"6","1063","35","13","24","1135"
"Natrona",2016,"7","1005","24","19","34","1082"
"Natrona",2016,"8","1069","30","21","21","1141"
"Natrona",2016,"9","1152","24","20","18","1214"
"Natrona",2016,"10","1046","30","21","9","1106"
"Natrona",2016,"11","1033","24","20","7","1084"
"Natrona",2016,"12","1024","18","21","18","1081"
"Natrona",2016,"13","998","25","20","11","1054"
"Natrona",2016,"14","936","19","13","7","975"
"Natrona",2016,"15","960","26","27","13","1026"
"Natrona",2016,"16","935","19","18","8","980"
"Natrona",2016,"17","946","19","21","23","1009"
"Natrona",2016,"18 to 20","2506","96","67","42","2711"
"Natrona",2016,"21 to 24","3773","97","105","54","4029"
"Natrona",2016,"25 & over","52458","795","756","595","54604"
"Natrona",2016,"Total","77223","1505","1311","1000","81039"
"Washakie",2003,"0","109","1","0","2","112"
"Washakie",2003,"1","76","1","2","2","81"
"Washakie",2003,"2","102","0","2","2","106"
"Washakie",2003,"3","85","1","0","0","86"
"Washakie",2003,"4","108","1","1","0","110"
"Washakie",2003,"5","111","1","2","1","115"
"Washakie",2003,"6","103","1","1","1","106"
"Washakie",2003,"7","92","0","1","2","95"
"Washakie",2003,"8","106","1","1","0","108"
"Washakie",2003,"9","85","2","1","2","90"
"Washakie",2003,"10","89","0","0","0","89"
"Washakie",2003,"11","111","0","1","0","112"
"Washakie",2003,"12","107","0","4","1","112"
"Washakie",2003,"13","140","1","1","2","144"
"Washakie",2003,"14","117","0","3","1","121"
"Washakie",2003,"15","127","0","0","1","128"
"Washakie",2003,"16","148","3","3","0","154"
"Washakie",2003,"17","150","1","4","1","156"
"Washakie",2003,"18 to 20","278","2","4","2","286"
"Washakie",2003,"21 to 24","307","1","0","5","313"
"Washakie",2003,"25 & over","5257","8","45","42","5352"
"Washakie",2003,"Total","7808","25","76","67","7976"
"Washakie",1996,"0","97","0","0","1","98"
"Washakie",1996,"1","105","0","3","0","108"
"Washakie",1996,"2","103","0","0","1","104"
"Washakie",1996,"3","95","0","0","0","95"
"Washakie",1996,"4","98","0","0","0","98"
"Washakie",1996,"5","107","0","6","2","115"
"Washakie",1996,"6","104","0","0","1","105"
"Washakie",1996,"7","114","0","0","0","114"
"Washakie",1996,"8","131","0","0","0","131"
"Washakie",1996,"9","142","0","0","0","142"
"Washakie",1996,"10","158","0","0","1","159"
"Washakie",1996,"11","152","0","0","0","152"
"Washakie",1996,"12","144","0","2","2","148"
"Washakie",1996,"13","156","0","1","0","157"
"Washakie",1996,"14","169","0","2","0","171"
"Washakie",1996,"15","176","0","5","0","181"
"Washakie",1996,"16","183","0","0","0","183"
"Washakie",1996,"17","147","0","0","1","148"
"Washakie",1996,"18 to 20","273","1","1","0","275"
"Washakie",1996,"21 to 24","276","0","0","0","276"
"Washakie",1996,"25 & over","5463","2","23","23","5511"
"Washakie",1996,"Total","8393","3","43","32","8471"
"Natrona",1991,"0","918","9","13","1","941"
"Natrona",1991,"1","925","10","8","5","948"
"Natrona",1991,"2","872","11","7","1","891"
"Natrona",1991,"3","897","11","10","9","927"
"Natrona",1991,"4","970","15","8","3","996"
"Natrona",1991,"5","990","9","9","6","1014"
"Natrona",1991,"6","1023","9","8","2","1042"
"Natrona",1991,"7","1045","20","6","10","1081"
"Natrona",1991,"8","1055","12","12","5","1084"
"Natrona",1991,"9","1083","8","10","13","1114"
"Natrona",1991,"10","1121","15","10","7","1153"
"Natrona",1991,"11","1106","11","8","4","1129"
"Natrona",1991,"12","1003","9","9","6","1027"
"Natrona",1991,"13","966","7","12","7","992"
"Natrona",1991,"14","941","9","8","7","965"
"Natrona",1991,"15","936","8","9","9","962"
"Natrona",1991,"16","896","7","3","3","909"
"Natrona",1991,"17","909","9","5","4","927"
"Natrona",1991,"18 to 20","2610","61","23","14","2708"
"Natrona",1991,"21 to 24","2612","16","27","11","2666"
"Natrona",1991,"25 & over","38174","226","273","163","38836"
"Natrona",1991,"Total","61052","492","478","290","62312"
"Carbon",2011,"0","187","4","4","3","198"
"Carbon",2011,"1","205","3","3","1","212"
"Carbon",2011,"2","224","3","1","0","228"
"Carbon",2011,"3","215","3","1","3","222"
"Carbon",2011,"4","220","2","2","3","227"
"Carbon",2011,"5","195","5","1","2","203"
"Carbon",2011,"6","200","3","5","3","211"
"Carbon",2011,"7","206","3","0","1","210"
"Carbon",2011,"8","205","7","2","1","215"
"Carbon",2011,"9","179","3","5","2","189"
"Carbon",2011,"10","199","3","7","2","211"
"Carbon",2011,"11","191","7","3","1","202"
"Carbon",2011,"12","201","2","6","1","210"
"Carbon",2011,"13","188","1","2","1","192"
"Carbon",2011,"14","192","0","4","2","198"
"Carbon",2011,"15","176","0","4","2","182"
"Carbon",2011,"16","180","1","5","2","188"
"Carbon",2011,"17","184","2","7","1","194"
"Carbon",2011,"18 to 20","455","10","12","2","479"
"Carbon",2011,"21 to 24","744","18","18","10","790"
"Carbon",2011,"25 & over","10486","115","163","99","10863"
"Carbon",2011,"Total","15232","195","255","142","15824"
"Weston",2005,"0","52","0","3","0","55"
"Weston",2005,"1","71","2","1","1","75"
"Weston",2005,"2","60","1","2","1","64"
"Weston",2005,"3","54","2","3","0","59"
"Weston",2005,"4","70","1","2","0","73"
"Weston",2005,"5","71","0","2","0","73"
"Weston",2005,"6","78","0","2","1","81"
"Weston",2005,"7","70","0","1","0","71"
"Weston",2005,"8","73","1","1","1","76"
"Weston",2005,"9","73","0","1","0","74"
"Weston",2005,"10","61","0","0","0","61"
"Weston",2005,"11","77","0","2","0","79"
"Weston",2005,"12","70","1","2","0","73"
"Weston",2005,"13","81","1","2","0","84"
"Weston",2005,"14","84","0","3","0","87"
"Weston",2005,"15","98","0","2","0","100"
"Weston",2005,"16","113","0","2","0","115"
"Weston",2005,"17","98","0","0","0","98"
"Weston",2005,"18 to 20","248","1","11","1","261"
"Weston",2005,"21 to 24","332","3","3","0","338"
"Weston",2005,"25 & over","4519","15","52","11","4597"
"Weston",2005,"Total","6453","28","97","16","6594"
"Hot Springs",2016,"0","47","0","2","0","49"
"Hot Springs",2016,"1","39","1","1","0","41"
"Hot Springs",2016,"2","48","4","3","0","55"
"Hot Springs",2016,"3","46","0","2","0","48"
"Hot Springs",2016,"4","54","0","1","0","55"
"Hot Springs",2016,"5","46","0","0","0","46"
"Hot Springs",2016,"6","49","1","2","1","53"
"Hot Springs",2016,"7","48","1","0","0","49"
"Hot Springs",2016,"8","49","0","1","0","50"
"Hot Springs",2016,"9","66","3","2","0","71"
"Hot Springs",2016,"10","51","0","0","0","51"
"Hot Springs",2016,"11","62","0","0","0","62"
"Hot Springs",2016,"12","52","0","2","0","54"
"Hot Springs",2016,"13","58","0","0","1","59"
"Hot Springs",2016,"14","53","1","1","0","55"
"Hot Springs",2016,"15","49","0","1","1","51"
"Hot Springs",2016,"16","53","1","0","0","54"
"Hot Springs",2016,"17","61","0","1","0","62"
"Hot Springs",2016,"18 to 20","110","2","2","4","118"
"Hot Springs",2016,"21 to 24","141","3","5","2","151"
"Hot Springs",2016,"25 & over","3341","31","48","25","3445"
"Hot Springs",2016,"Total","4523","48","74","34","4679"
"Niobrara",2016,"0","22","0","2","0","24"
"Niobrara",2016,"1","25","1","0","0","26"
"Niobrara",2016,"2","20","1","2","0","23"
"Niobrara",2016,"3","28","1","0","0","29"
"Niobrara",2016,"4","24","0","2","0","26"
"Niobrara",2016,"5","21","0","2","0","23"
"Niobrara",2016,"6","22","0","0","0","22"
"Niobrara",2016,"7","23","0","1","0","24"
"Niobrara",2016,"8","22","0","0","0","22"
"Niobrara",2016,"9","22","0","0","0","22"
"Niobrara",2016,"10","20","0","2","0","22"
"Niobrara",2016,"11","18","1","0","0","19"
"Niobrara",2016,"12","18","0","2","0","20"
"Niobrara",2016,"13","31","0","0","1","32"
"Niobrara",2016,"14","22","1","0","1","24"
"Niobrara",2016,"15","34","0","0","1","35"
"Niobrara",2016,"16","16","1","0","0","17"
"Niobrara",2016,"17","42","0","0","1","43"
"Niobrara",2016,"18 to 20","68","3","1","1","73"
"Niobrara",2016,"21 to 24","110","5","1","2","118"
"Niobrara",2016,"25 & over","1772","25","30","9","1836"
"Niobrara",2016,"Total","2380","39","45","16","2480"
"Laramie",1991,"0","1108","40","17","12","1177"
"Laramie",1991,"1","1102","55","7","14","1178"
"Laramie",1991,"2","1067","61","15","20","1163"
"Laramie",1991,"3","1060","64","10","18","1152"
"Laramie",1991,"4","1061","58","12","11","1142"
"Laramie",1991,"5","1098","48","10","16","1172"
"Laramie",1991,"6","1090","47","19","12","1168"
"Laramie",1991,"7","1091","50","8","11","1160"
"Laramie",1991,"8","1095","36","8","14","1153"
"Laramie",1991,"9","1148","49","11","10","1218"
"Laramie",1991,"10","1139","48","16","20","1223"
"Laramie",1991,"11","1132","55","13","22","1222"
"Laramie",1991,"12","1055","35","15","7","1112"
"Laramie",1991,"13","1055","31","10","10","1106"
"Laramie",1991,"14","1007","38","19","18","1082"
"Laramie",1991,"15","1015","42","5","16","1078"
"Laramie",1991,"16","1017","31","8","12","1068"
"Laramie",1991,"17","996","37","6","22","1061"
"Laramie",1991,"18 to 20","2934","131","43","51","3159"
"Laramie",1991,"21 to 24","3888","189","40","72","4189"
"Laramie",1991,"25 & over","44061","1131","316","487","45995"
"Laramie",1991,"Total","70219","2276","608","875","73978"
"Albany",2009,"0","419","9","6","12","446"
"Albany",2009,"1","361","21","5","10","397"
"Albany",2009,"2","368","10","4","13","395"
"Albany",2009,"3","369","11","6","7","393"
"Albany",2009,"4","308","9","10","18","345"
"Albany",2009,"5","319","12","13","4","348"
"Albany",2009,"6","282","8","3","6","299"
"Albany",2009,"7","277","5","5","9","296"
"Albany",2009,"8","303","8","7","9","327"
"Albany",2009,"9","279","3","3","8","293"
"Albany",2009,"10","240","10","5","4","259"
"Albany",2009,"11","278","9","3","8","298"
"Albany",2009,"12","266","9","1","12","288"
"Albany",2009,"13","318","4","1","6","329"
"Albany",2009,"14","259","4","4","8","275"
"Albany",2009,"15","292","6","3","6","307"
"Albany",2009,"16","305","6","4","22","337"
"Albany",2009,"17","308","14","7","5","334"
"Albany",2009,"18 to 20","4495","91","46","99","4731"
"Albany",2009,"21 to 24","5469","104","57","220","5850"
"Albany",2009,"25 & over","18189","235","177","595","19196"
"Albany",2009,"Total","33704","588","370","1081","35743"
"Lincoln",2012,"0","244","1","6","0","251"
"Lincoln",2012,"1","230","2","0","0","232"
"Lincoln",2012,"2","250","0","2","2","254"
"Lincoln",2012,"3","263","1","3","0","267"
"Lincoln",2012,"4","287","2","3","0","292"
"Lincoln",2012,"5","294","4","2","1","301"
"Lincoln",2012,"6","288","1","1","4","294"
"Lincoln",2012,"7","284","2","6","3","295"
"Lincoln",2012,"8","249","4","4","0","257"
"Lincoln",2012,"9","272","1","4","1","278"
"Lincoln",2012,"10","259","4","3","0","266"
"Lincoln",2012,"11","263","1","2","0","266"
"Lincoln",2012,"12","281","4","2","1","288"
"Lincoln",2012,"13","280","5","2","0","287"
"Lincoln",2012,"14","270","2","1","2","275"
"Lincoln",2012,"15","266","2","3","2","273"
"Lincoln",2012,"16","259","2","3","1","265"
"Lincoln",2012,"17","247","4","5","0","256"
"Lincoln",2012,"18 to 20","562","12","10","4","588"
"Lincoln",2012,"21 to 24","537","9","14","0","560"
"Lincoln",2012,"25 & over","11620","100","104","71","11895"
"Lincoln",2012,"Total","17505","163","180","92","17940"
"Sweetwater",1996,"0","532","8","5","2","547"
"Sweetwater",1996,"1","553","5","6","3","567"
"Sweetwater",1996,"2","532","7","8","1","548"
"Sweetwater",1996,"3","537","12","9","1","559"
"Sweetwater",1996,"4","535","4","6","1","546"
"Sweetwater",1996,"5","541","5","9","3","558"
"Sweetwater",1996,"6","635","10","8","1","654"
"Sweetwater",1996,"7","621","5","14","5","645"
"Sweetwater",1996,"8","632","3","5","2","642"
"Sweetwater",1996,"9","691","6","5","4","706"
"Sweetwater",1996,"10","678","4","12","1","695"
"Sweetwater",1996,"11","724","3","9","3","739"
"Sweetwater",1996,"12","752","6","7","5","770"
"Sweetwater",1996,"13","826","5","11","2","844"
"Sweetwater",1996,"14","784","7","10","1","802"
"Sweetwater",1996,"15","760","11","7","1","779"
"Sweetwater",1996,"16","807","10","8","6","831"
"Sweetwater",1996,"17","789","4","10","5","808"
"Sweetwater",1996,"18 to 20","1825","15","15","22","1877"
"Sweetwater",1996,"21 to 24","1782","19","20","18","1839"
"Sweetwater",1996,"25 & over","22796","162","190","153","23301"
"Sweetwater",1996,"Total","38332","311","374","240","39257"
"Carbon",1999,"0","168","0","0","2","170"
"Carbon",1999,"1","185","0","0","1","186"
"Carbon",1999,"2","179","2","0","0","181"
"Carbon",1999,"3","174","0","6","0","180"
"Carbon",1999,"4","180","0","0","0","180"
"Carbon",1999,"5","187","2","5","0","194"
"Carbon",1999,"6","181","0","3","0","184"
"Carbon",1999,"7","192","0","0","2","194"
"Carbon",1999,"8","198","3","9","1","211"
"Carbon",1999,"9","200","0","0","3","203"
"Carbon",1999,"10","205","4","6","4","219"
"Carbon",1999,"11","198","5","5","0","208"
"Carbon",1999,"12","225","3","0","4","232"
"Carbon",1999,"13","242","0","0","0","242"
"Carbon",1999,"14","257","0","0","3","260"
"Carbon",1999,"15","259","2","0","16","277"
"Carbon",1999,"16","271","0","0","3","274"
"Carbon",1999,"17","284","0","0","2","286"
"Carbon",1999,"18 to 20","572","10","16","4","602"
"Carbon",1999,"21 to 24","725","10","13","3","751"
"Carbon",1999,"25 & over","10268","66","107","55","10496"
"Carbon",1999,"Total","15350","107","170","103","15730"
"Lincoln",1990,"0","211","0","3","0","214"
"Lincoln",1990,"1","225","0","3","1","229"
"Lincoln",1990,"2","238","0","1","0","239"
"Lincoln",1990,"3","242","0","0","0","242"
"Lincoln",1990,"4","235","0","0","0","235"
"Lincoln",1990,"5","261","1","0","0","262"
"Lincoln",1990,"6","263","0","0","2","265"
"Lincoln",1990,"7","304","0","0","0","304"
"Lincoln",1990,"8","303","0","3","0","306"
"Lincoln",1990,"9","313","0","2","0","315"
"Lincoln",1990,"10","313","1","4","2","320"
"Lincoln",1990,"11","324","0","1","0","325"
"Lincoln",1990,"12","277","0","2","0","279"
"Lincoln",1990,"13","285","0","4","0","289"
"Lincoln",1990,"14","267","0","1","0","268"
"Lincoln",1990,"15","269","1","1","0","271"
"Lincoln",1990,"16","262","0","2","0","264"
"Lincoln",1990,"17","230","0","1","0","231"
"Lincoln",1990,"18 to 20","405","1","7","0","413"
"Lincoln",1990,"21 to 24","359","0","0","0","359"
"Lincoln",1990,"25 & over","7035","1","23","21","7080"
"Lincoln",1990,"Total","12621","5","58","26","12710"
"Hot Springs",2002,"0","44","0","1","0","45"
"Hot Springs",2002,"1","47","2","3","0","52"
"Hot Springs",2002,"2","43","2","4","1","50"
"Hot Springs",2002,"3","48","0","0","0","48"
"Hot Springs",2002,"4","48","1","0","0","49"
"Hot Springs",2002,"5","38","0","1","0","39"
"Hot Springs",2002,"6","59","0","1","0","60"
"Hot Springs",2002,"7","45","1","1","0","47"
"Hot Springs",2002,"8","43","0","0","0","43"
"Hot Springs",2002,"9","51","0","2","0","53"
"Hot Springs",2002,"10","51","0","0","0","51"
"Hot Springs",2002,"11","66","0","4","0","70"
"Hot Springs",2002,"12","63","0","2","1","66"
"Hot Springs",2002,"13","62","0","2","0","64"
"Hot Springs",2002,"14","72","1","2","0","75"
"Hot Springs",2002,"15","60","0","3","0","63"
"Hot Springs",2002,"16","78","0","3","0","81"
"Hot Springs",2002,"17","61","0","0","0","61"
"Hot Springs",2002,"18 to 20","171","0","4","1","176"
"Hot Springs",2002,"21 to 24","130","1","4","0","135"
"Hot Springs",2002,"25 & over","3354","8","44","9","3415"
"Hot Springs",2002,"Total","4634","16","81","12","4743"
"Washakie",2011,"0","105","2","1","0","108"
"Washakie",2011,"1","99","4","0","1","104"
"Washakie",2011,"2","100","3","1","1","105"
"Washakie",2011,"3","103","2","1","2","108"
"Washakie",2011,"4","115","1","2","1","119"
"Washakie",2011,"5","120","1","5","0","126"
"Washakie",2011,"6","125","0","2","1","128"
"Washakie",2011,"7","118","0","1","3","122"
"Washakie",2011,"8","123","1","2","2","128"
"Washakie",2011,"9","127","0","3","0","130"
"Washakie",2011,"10","111","0","1","0","112"
"Washakie",2011,"11","107","0","1","1","109"
"Washakie",2011,"12","117","0","3","1","121"
"Washakie",2011,"13","118","0","8","0","126"
"Washakie",2011,"14","116","1","2","2","121"
"Washakie",2011,"15","108","0","4","0","112"
"Washakie",2011,"16","120","3","5","3","131"
"Washakie",2011,"17","130","3","1","1","135"
"Washakie",2011,"18 to 20","237","2","10","3","252"
"Washakie",2011,"21 to 24","244","3","2","9","258"
"Washakie",2011,"25 & over","5662","26","85","42","5815"
"Washakie",2011,"Total","8205","52","140","73","8470"
"Sublette",2011,"0","134","0","1","0","135"
"Sublette",2011,"1","103","2","0","0","105"
"Sublette",2011,"2","144","3","2","2","151"
"Sublette",2011,"3","151","3","2","1","157"
"Sublette",2011,"4","145","3","3","0","151"
"Sublette",2011,"5","132","0","3","2","137"
"Sublette",2011,"6","133","2","3","1","139"
"Sublette",2011,"7","128","1","2","4","135"
"Sublette",2011,"8","136","1","1","2","140"
"Sublette",2011,"9","135","0","2","5","142"
"Sublette",2011,"10","121","0","1","4","126"
"Sublette",2011,"11","136","0","2","3","141"
"Sublette",2011,"12","129","1","3","1","134"
"Sublette",2011,"13","126","2","2","1","131"
"Sublette",2011,"14","129","1","2","0","132"
"Sublette",2011,"15","123","0","1","1","125"
"Sublette",2011,"16","121","3","2","1","127"
"Sublette",2011,"17","141","1","6","0","148"
"Sublette",2011,"18 to 20","279","3","10","1","293"
"Sublette",2011,"21 to 24","407","5","3","12","427"
"Sublette",2011,"25 & over","6799","61","70","39","6969"
"Sublette",2011,"Total","9852","92","121","80","10145"
"Niobrara",2013,"0","27","0","0","0","27"
"Niobrara",2013,"1","20","0","1","0","21"
"Niobrara",2013,"2","25","0","0","0","25"
"Niobrara",2013,"3","26","0","0","0","26"
"Niobrara",2013,"4","23","0","1","0","24"
"Niobrara",2013,"5","13","0","0","0","13"
"Niobrara",2013,"6","22","0","0","0","22"
"Niobrara",2013,"7","23","0","2","0","25"
"Niobrara",2013,"8","17","0","0","0","17"
"Niobrara",2013,"9","20","0","0","0","20"
"Niobrara",2013,"10","32","1","0","0","33"
"Niobrara",2013,"11","29","0","0","0","29"
"Niobrara",2013,"12","30","0","0","0","30"
"Niobrara",2013,"13","21","1","0","0","22"
"Niobrara",2013,"14","35","0","0","0","35"
"Niobrara",2013,"15","28","1","0","0","29"
"Niobrara",2013,"16","35","0","0","0","35"
"Niobrara",2013,"17","25","0","0","1","26"
"Niobrara",2013,"18 to 20","65","3","0","1","69"
"Niobrara",2013,"21 to 24","99","3","3","0","105"
"Niobrara",2013,"25 & over","1861","21","23","8","1913"
"Niobrara",2013,"Total","2476","30","30","10","2546"
"Converse",2010,"0","180","2","5","1","188"
"Converse",2010,"1","175","3","1","2","181"
"Converse",2010,"2","191","1","1","0","193"
"Converse",2010,"3","201","5","1","2","209"
"Converse",2010,"4","192","5","4","1","202"
"Converse",2010,"5","198","5","2","1","206"
"Converse",2010,"6","180","1","3","0","184"
"Converse",2010,"7","184","2","2","1","189"
"Converse",2010,"8","191","2","3","1","197"
"Converse",2010,"9","188","1","0","1","190"
"Converse",2010,"10","195","2","0","1","198"
"Converse",2010,"11","197","4","1","0","202"
"Converse",2010,"12","174","4","1","0","179"
"Converse",2010,"13","188","3","2","0","193"
"Converse",2010,"14","187","6","1","0","194"
"Converse",2010,"15","169","3","0","0","172"
"Converse",2010,"16","207","3","2","0","212"
"Converse",2010,"17","217","2","2","1","222"
"Converse",2010,"18 to 20","452","3","2","0","457"
"Converse",2010,"21 to 24","572","2","5","2","581"
"Converse",2010,"25 & over","9118","32","90","38","9278"
"Converse",2010,"Total","13556","91","128","52","13827"
"Crook",2014,"0","98","0","0","0","98"
"Crook",2014,"1","90","0","0","0","90"
"Crook",2014,"2","113","2","0","0","115"
"Crook",2014,"3","88","0","1","0","89"
"Crook",2014,"4","111","0","1","0","112"
"Crook",2014,"5","83","0","3","0","86"
"Crook",2014,"6","115","2","1","1","119"
"Crook",2014,"7","97","2","2","1","102"
"Crook",2014,"8","91","1","2","1","95"
"Crook",2014,"9","89","1","1","0","91"
"Crook",2014,"10","87","1","1","0","89"
"Crook",2014,"11","88","1","1","0","90"
"Crook",2014,"12","94","1","2","1","98"
"Crook",2014,"13","83","2","3","0","88"
"Crook",2014,"14","90","2","1","0","93"
"Crook",2014,"15","75","0","3","0","78"
"Crook",2014,"16","76","1","0","0","77"
"Crook",2014,"17","97","1","2","0","100"
"Crook",2014,"18 to 20","231","8","3","4","246"
"Crook",2014,"21 to 24","260","2","1","1","264"
"Crook",2014,"25 & over","4900","66","39","12","5017"
"Crook",2014,"Total","7056","93","67","21","7237"
"Teton",2004,"0","229","2","2","1","234"
"Teton",2004,"1","215","1","0","1","217"
"Teton",2004,"2","185","1","2","4","192"
"Teton",2004,"3","186","2","1","1","190"
"Teton",2004,"4","139","0","1","2","142"
"Teton",2004,"5","166","1","2","3","172"
"Teton",2004,"6","178","2","0","2","182"
"Teton",2004,"7","195","2","1","3","201"
"Teton",2004,"8","169","1","2","2","174"
"Teton",2004,"9","179","1","0","4","184"
"Teton",2004,"10","229","2","2","2","235"
"Teton",2004,"11","175","1","1","2","179"
"Teton",2004,"12","238","2","0","2","242"
"Teton",2004,"13","221","1","0","2","224"
"Teton",2004,"14","238","0","2","2","242"
"Teton",2004,"15","248","0","3","2","253"
"Teton",2004,"16","221","0","2","1","224"
"Teton",2004,"17","235","2","2","2","241"
"Teton",2004,"18 to 20","540","3","3","7","553"
"Teton",2004,"21 to 24","1189","4","12","15","1220"
"Teton",2004,"25 & over","13681","43","102","140","13966"
"Teton",2004,"Total","19056","71","140","200","19467"
"Sweetwater",1998,"0","516","12","4","0","532"
"Sweetwater",1998,"1","555","4","6","5","570"
"Sweetwater",1998,"2","515","8","12","0","535"
"Sweetwater",1998,"3","514","15","7","0","536"
"Sweetwater",1998,"4","508","3","4","0","515"
"Sweetwater",1998,"5","505","8","7","3","523"
"Sweetwater",1998,"6","584","8","13","1","606"
"Sweetwater",1998,"7","581","3","22","2","608"
"Sweetwater",1998,"8","643","4","6","2","655"
"Sweetwater",1998,"9","627","3","8","5","643"
"Sweetwater",1998,"10","588","2","9","2","601"
"Sweetwater",1998,"11","640","6","11","2","659"
"Sweetwater",1998,"12","694","8","6","3","711"
"Sweetwater",1998,"13","772","4","11","3","790"
"Sweetwater",1998,"14","727","10","8","1","746"
"Sweetwater",1998,"15","746","12","10","1","769"
"Sweetwater",1998,"16","790","7","6","5","808"
"Sweetwater",1998,"17","805","3","10","5","823"
"Sweetwater",1998,"18 to 20","1929","19","27","26","2001"
"Sweetwater",1998,"21 to 24","1798","19","18","21","1856"
"Sweetwater",1998,"25 & over","22558","151","205","164","23078"
"Sweetwater",1998,"Total","37595","309","410","251","38565"
"Campbell",1990,"0","494","0","9","2","505"
"Campbell",1990,"1","505","3","10","2","520"
"Campbell",1990,"2","516","1","7","0","524"
"Campbell",1990,"3","546","0","6","0","552"
"Campbell",1990,"4","595","1","8","0","604"
"Campbell",1990,"5","632","0","11","0","643"
"Campbell",1990,"6","630","0","4","1","635"
"Campbell",1990,"7","652","0","12","0","664"
"Campbell",1990,"8","619","1","6","1","627"
"Campbell",1990,"9","639","0","13","7","659"
"Campbell",1990,"10","681","6","10","6","703"
"Campbell",1990,"11","584","0","7","0","591"
"Campbell",1990,"12","605","0","14","1","620"
"Campbell",1990,"13","578","0","7","3","588"
"Campbell",1990,"14","546","0","3","0","549"
"Campbell",1990,"15","531","1","5","5","542"
"Campbell",1990,"16","501","4","5","2","512"
"Campbell",1990,"17","493","2","8","2","505"
"Campbell",1990,"18 to 20","1001","1","14","0","1016"
"Campbell",1990,"21 to 24","1120","2","29","5","1156"
"Campbell",1990,"25 & over","16486","11","149","42","16688"
"Campbell",1990,"Total","28954","33","337","79","29403"
"Albany",2015,"0","386","10","8","18","422"
"Albany",2015,"1","367","18","7","11","403"
"Albany",2015,"2","336","16","4","17","373"
"Albany",2015,"3","350","16","12","17","395"
"Albany",2015,"4","325","18","5","18","366"
"Albany",2015,"5","348","19","9","10","386"
"Albany",2015,"6","341","21","8","8","378"
"Albany",2015,"7","324","14","8","10","356"
"Albany",2015,"8","341","8","6","13","368"
"Albany",2015,"9","317","8","7","8","340"
"Albany",2015,"10","294","6","7","7","314"
"Albany",2015,"11","284","10","6","6","306"
"Albany",2015,"12","275","4","3","7","289"
"Albany",2015,"13","275","9","7","12","303"
"Albany",2015,"14","291","7","5","13","316"
"Albany",2015,"15","277","8","7","8","300"
"Albany",2015,"16","252","11","8","6","277"
"Albany",2015,"17","291","21","5","14","331"
"Albany",2015,"18 to 20","3790","66","23","190","4069"
"Albany",2015,"21 to 24","6426","195","99","227","6947"
"Albany",2015,"25 & over","19437","408","267","728","20840"
"Albany",2015,"Total","35327","893","511","1348","38079"
"Laramie",2006,"0","1177","88","33","17","1315"
"Laramie",2006,"1","1145","60","26","19","1250"
"Laramie",2006,"2","1114","78","19","30","1241"
"Laramie",2006,"3","1047","51","13","18","1129"
"Laramie",2006,"4","1063","69","36","33","1201"
"Laramie",2006,"5","1064","61","24","18","1167"
"Laramie",2006,"6","1045","62","16","31","1154"
"Laramie",2006,"7","1001","28","15","30","1074"
"Laramie",2006,"8","1031","57","21","23","1132"
"Laramie",2006,"9","1034","45","14","10","1103"
"Laramie",2006,"10","1050","32","28","10","1120"
"Laramie",2006,"11","1100","57","26","11","1194"
"Laramie",2006,"12","1079","45","22","17","1163"
"Laramie",2006,"13","1195","46","13","25","1279"
"Laramie",2006,"14","1082","68","15","20","1185"
"Laramie",2006,"15","1137","52","19","21","1229"
"Laramie",2006,"16","1154","23","18","17","1212"
"Laramie",2006,"17","1099","37","15","17","1168"
"Laramie",2006,"18 to 20","3275","186","59","68","3588"
"Laramie",2006,"21 to 24","4987","335","74","104","5500"
"Laramie",2006,"25 & over","53818","1219","611","767","56415"
"Laramie",2006,"Total","81697","2699","1117","1306","86819"
"Fremont",2014,"0","333","7","263","1","604"
"Fremont",2014,"1","326","12","231","2","571"
"Fremont",2014,"2","349","4","257","2","612"
"Fremont",2014,"3","341","12","264","6","623"
"Fremont",2014,"4","379","4","236","9","628"
"Fremont",2014,"5","388","5","212","2","607"
"Fremont",2014,"6","377","4","235","3","619"
"Fremont",2014,"7","409","6","201","4","620"
"Fremont",2014,"8","383","5","238","2","628"
"Fremont",2014,"9","350","4","232","6","592"
"Fremont",2014,"10","336","6","213","5","560"
"Fremont",2014,"11","348","3","200","3","554"
"Fremont",2014,"12","340","6","203","3","552"
"Fremont",2014,"13","334","7","173","3","517"
"Fremont",2014,"14","334","5","175","0","514"
"Fremont",2014,"15","359","4","167","1","531"
"Fremont",2014,"16","348","6","180","3","537"
"Fremont",2014,"17","353","6","170","6","535"
"Fremont",2014,"18 to 20","947","19","420","10","1396"
"Fremont",2014,"21 to 24","1344","17","615","14","1990"
"Fremont",2014,"25 & over","21990","194","4537","169","26890"
"Fremont",2014,"Total","30668","336","9422","254","40680"
"Carbon",2015,"0","201","6","7","2","216"
"Carbon",2015,"1","168","2","1","1","172"
"Carbon",2015,"2","190","5","10","1","206"
"Carbon",2015,"3","209","3","3","1","216"
"Carbon",2015,"4","220","6","6","2","234"
"Carbon",2015,"5","203","4","4","1","212"
"Carbon",2015,"6","203","2","3","1","209"
"Carbon",2015,"7","219","4","3","1","227"
"Carbon",2015,"8","206","3","3","4","216"
"Carbon",2015,"9","207","5","2","1","215"
"Carbon",2015,"10","173","5","3","4","185"
"Carbon",2015,"11","192","3","3","1","199"
"Carbon",2015,"12","206","2","2","1","211"
"Carbon",2015,"13","181","7","5","0","193"
"Carbon",2015,"14","182","2","6","3","193"
"Carbon",2015,"15","186","5","2","1","194"
"Carbon",2015,"16","189","2","5","3","199"
"Carbon",2015,"17","189","5","2","2","198"
"Carbon",2015,"18 to 20","433","6","8","4","451"
"Carbon",2015,"21 to 24","698","19","22","28","767"
"Carbon",2015,"25 & over","10166","161","190","124","10641"
"Carbon",2015,"Total","14821","257","290","186","15554"
"Laramie",1999,"0","998","53","11","13","1075"
"Laramie",1999,"1","1014","59","8","21","1102"
"Laramie",1999,"2","1016","31","11","22","1080"
"Laramie",1999,"3","1011","48","8","14","1081"
"Laramie",1999,"4","966","55","30","19","1070"
"Laramie",1999,"5","1056","49","15","18","1138"
"Laramie",1999,"6","1069","41","22","16","1148"
"Laramie",1999,"7","1152","48","11","23","1234"
"Laramie",1999,"8","1094","30","12","15","1151"
"Laramie",1999,"9","1147","84","13","14","1258"
"Laramie",1999,"10","1106","40","18","18","1182"
"Laramie",1999,"11","1096","64","14","14","1188"
"Laramie",1999,"12","1135","45","16","17","1213"
"Laramie",1999,"13","1178","30","11","19","1238"
"Laramie",1999,"14","1193","31","31","13","1268"
"Laramie",1999,"15","1196","66","7","16","1285"
"Laramie",1999,"16","1204","33","16","13","1266"
"Laramie",1999,"17","1111","29","9","15","1164"
"Laramie",1999,"18 to 20","3094","197","53","57","3401"
"Laramie",1999,"21 to 24","4063","231","76","87","4457"
"Laramie",1999,"25 & over","49711","1252","438","609","52010"
"Laramie",1999,"Total","76610","2516","830","1053","81009"
"Lincoln",2007,"0","296","0","1","1","298"
"Lincoln",2007,"1","277","2","2","1","282"
"Lincoln",2007,"2","255","1","4","0","260"
"Lincoln",2007,"3","203","0","2","0","205"
"Lincoln",2007,"4","267","1","2","2","272"
"Lincoln",2007,"5","250","1","5","2","258"
"Lincoln",2007,"6","239","1","3","0","243"
"Lincoln",2007,"7","271","0","6","0","277"
"Lincoln",2007,"8","252","2","3","0","257"
"Lincoln",2007,"9","242","2","3","0","247"
"Lincoln",2007,"10","283","2","3","1","289"
"Lincoln",2007,"11","248","3","2","0","253"
"Lincoln",2007,"12","260","2","1","2","265"
"Lincoln",2007,"13","271","3","4","0","278"
"Lincoln",2007,"14","282","2","3","0","287"
"Lincoln",2007,"15","241","2","4","1","248"
"Lincoln",2007,"16","298","3","3","2","306"
"Lincoln",2007,"17","266","0","4","0","270"
"Lincoln",2007,"18 to 20","511","2","3","1","517"
"Lincoln",2007,"21 to 24","639","2","10","1","652"
"Lincoln",2007,"25 & over","10891","19","93","46","11049"
"Lincoln",2007,"Total","16742","50","161","60","17013"
"Teton",2014,"0","246","0","1","0","247"
"Teton",2014,"1","236","5","0","1","242"
"Teton",2014,"2","223","2","1","2","228"
"Teton",2014,"3","244","3","1","2","250"
"Teton",2014,"4","266","2","7","4","279"
"Teton",2014,"5","270","2","5","5","282"
"Teton",2014,"6","263","3","3","6","275"
"Teton",2014,"7","277","1","2","3","283"
"Teton",2014,"8","232","2","5","4","243"
"Teton",2014,"9","238","6","1","4","249"
"Teton",2014,"10","222","2","2","5","231"
"Teton",2014,"11","221","2","3","7","233"
"Teton",2014,"12","207","4","1","3","215"
"Teton",2014,"13","192","1","3","5","201"
"Teton",2014,"14","204","2","4","4","214"
"Teton",2014,"15","186","1","2","2","191"
"Teton",2014,"16","203","2","4","5","214"
"Teton",2014,"17","232","2","1","4","239"
"Teton",2014,"18 to 20","476","27","7","13","523"
"Teton",2014,"21 to 24","896","30","11","20","957"
"Teton",2014,"25 & over","16467","183","169","231","17050"
"Teton",2014,"Total","22001","282","233","330","22846"
"Sublette",2005,"0","83","0","0","0","83"
"Sublette",2005,"1","100","3","0","0","103"
"Sublette",2005,"2","83","0","0","0","83"
"Sublette",2005,"3","76","1","1","0","78"
"Sublette",2005,"4","71","0","2","1","74"
"Sublette",2005,"5","86","0","1","0","87"
"Sublette",2005,"6","91","0","1","1","93"
"Sublette",2005,"7","110","1","0","0","111"
"Sublette",2005,"8","94","0","1","1","96"
"Sublette",2005,"9","95","0","0","0","95"
"Sublette",2005,"10","78","0","0","0","78"
"Sublette",2005,"11","108","0","2","1","111"
"Sublette",2005,"12","94","1","1","0","96"
"Sublette",2005,"13","98","0","1","0","99"
"Sublette",2005,"14","101","0","1","0","102"
"Sublette",2005,"15","107","1","1","2","111"
"Sublette",2005,"16","123","0","2","0","125"
"Sublette",2005,"17","102","0","3","0","105"
"Sublette",2005,"18 to 20","220","3","3","3","229"
"Sublette",2005,"21 to 24","292","1","3","6","302"
"Sublette",2005,"25 & over","5159","36","37","22","5254"
"Sublette",2005,"Total","7371","47","60","37","7515"
"Sheridan",1990,"0","269","0","3","0","272"
"Sheridan",1990,"1","279","1","4","3","287"
"Sheridan",1990,"2","269","0","3","0","272"
"Sheridan",1990,"3","286","0","3","0","289"
"Sheridan",1990,"4","314","0","5","9","328"
"Sheridan",1990,"5","350","2","6","2","360"
"Sheridan",1990,"6","360","0","2","1","363"
"Sheridan",1990,"7","381","0","2","0","383"
"Sheridan",1990,"8","362","0","6","0","368"
"Sheridan",1990,"9","380","0","3","0","383"
"Sheridan",1990,"10","426","0","3","1","430"
"Sheridan",1990,"11","371","0","2","1","374"
"Sheridan",1990,"12","379","2","4","0","385"
"Sheridan",1990,"13","363","1","1","0","365"
"Sheridan",1990,"14","371","0","8","5","384"
"Sheridan",1990,"15","371","1","7","1","380"
"Sheridan",1990,"16","335","0","4","5","344"
"Sheridan",1990,"17","381","0","3","9","393"
"Sheridan",1990,"18 to 20","905","8","10","0","923"
"Sheridan",1990,"21 to 24","726","0","11","7","744"
"Sheridan",1990,"25 & over","15378","16","122","50","15566"
"Sheridan",1990,"Total","23256","31","212","94","23593"
"Park",1999,"0","267","0","2","1","270"
"Park",1999,"1","269","0","3","0","272"
"Park",1999,"2","310","0","4","3","317"
"Park",1999,"3","290","0","0","0","290"
"Park",1999,"4","281","0","1","6","288"
"Park",1999,"5","280","1","3","3","287"
"Park",1999,"6","288","0","0","0","288"
"Park",1999,"7","318","0","1","0","319"
"Park",1999,"8","354","0","3","0","357"
"Park",1999,"9","362","0","1","0","363"
"Park",1999,"10","345","0","3","0","348"
"Park",1999,"11","371","0","0","5","376"
"Park",1999,"12","399","0","9","3","411"
"Park",1999,"13","421","2","2","2","427"
"Park",1999,"14","410","2","0","2","414"
"Park",1999,"15","459","1","1","0","461"
"Park",1999,"16","419","0","5","2","426"
"Park",1999,"17","455","0","1","0","456"
"Park",1999,"18 to 20","1325","0","16","20","1361"
"Park",1999,"21 to 24","979","0","2","6","987"
"Park",1999,"25 & over","16789","7","80","70","16946"
"Park",1999,"Total","25391","13","137","123","25664"
"Sweetwater",2004,"0","534","13","9","7","563"
"Sweetwater",2004,"1","590","10","10","3","613"
"Sweetwater",2004,"2","542","20","14","5","581"
"Sweetwater",2004,"3","515","14","10","5","544"
"Sweetwater",2004,"4","534","9","7","2","552"
"Sweetwater",2004,"5","535","6","5","6","552"
"Sweetwater",2004,"6","509","6","10","3","528"
"Sweetwater",2004,"7","500","10","11","5","526"
"Sweetwater",2004,"8","470","7","5","4","486"
"Sweetwater",2004,"9","458","9","6","3","476"
"Sweetwater",2004,"10","526","7","14","2","549"
"Sweetwater",2004,"11","526","13","12","2","553"
"Sweetwater",2004,"12","573","6","7","2","588"
"Sweetwater",2004,"13","594","10","11","2","617"
"Sweetwater",2004,"14","576","11","9","6","602"
"Sweetwater",2004,"15","560","10","5","3","578"
"Sweetwater",2004,"16","580","8","7","5","600"
"Sweetwater",2004,"17","618","7","9","9","643"
"Sweetwater",2004,"18 to 20","1797","32","23","27","1879"
"Sweetwater",2004,"21 to 24","2332","33","35","40","2440"
"Sweetwater",2004,"25 & over","22860","230","258","208","23556"
"Sweetwater",2004,"Total","36729","471","477","349","38026"
"Sheridan",1991,"0","257","0","3","0","260"
"Sheridan",1991,"1","282","1","4","3","290"
"Sheridan",1991,"2","269","0","3","0","272"
"Sheridan",1991,"3","280","0","3","0","283"
"Sheridan",1991,"4","297","0","6","6","309"
"Sheridan",1991,"5","333","2","7","2","344"
"Sheridan",1991,"6","360","0","2","1","363"
"Sheridan",1991,"7","367","0","2","0","369"
"Sheridan",1991,"8","360","0","7","0","367"
"Sheridan",1991,"9","381","0","3","0","384"
"Sheridan",1991,"10","416","0","3","2","421"
"Sheridan",1991,"11","395","0","4","3","402"
"Sheridan",1991,"12","392","3","5","0","400"
"Sheridan",1991,"13","368","1","1","0","370"
"Sheridan",1991,"14","389","0","8","3","400"
"Sheridan",1991,"15","367","1","7","1","376"
"Sheridan",1991,"16","348","0","4","5","357"
"Sheridan",1991,"17","381","0","3","7","391"
"Sheridan",1991,"18 to 20","904","8","10","0","922"
"Sheridan",1991,"21 to 24","745","0","11","7","763"
"Sheridan",1991,"25 & over","15492","14","126","47","15679"
"Sheridan",1991,"Total","23383","30","222","87","23722"
"Fremont",2001,"0","253","3","239","1","496"
"Fremont",2001,"1","290","1","161","0","452"
"Fremont",2001,"2","302","3","192","1","498"
"Fremont",2001,"3","303","3","173","1","480"
"Fremont",2001,"4","297","2","128","1","428"
"Fremont",2001,"5","291","3","163","0","457"
"Fremont",2001,"6","307","2","142","2","453"
"Fremont",2001,"7","350","1","184","1","536"
"Fremont",2001,"8","336","3","155","1","495"
"Fremont",2001,"9","362","4","167","2","535"
"Fremont",2001,"10","369","1","197","1","568"
"Fremont",2001,"11","367","2","156","3","528"
"Fremont",2001,"12","396","3","206","3","608"
"Fremont",2001,"13","388","1","171","3","563"
"Fremont",2001,"14","443","0","164","2","609"
"Fremont",2001,"15","472","1","169","1","643"
"Fremont",2001,"16","461","3","150","2","616"
"Fremont",2001,"17","467","1","163","0","631"
"Fremont",2001,"18 to 20","1141","4","424","6","1575"
"Fremont",2001,"21 to 24","1044","3","419","13","1479"
"Fremont",2001,"25 & over","19394","33","3548","93","23068"
"Fremont",2001,"Total","28033","77","7471","137","35718"
"Sublette",2016,"0","110","3","2","2","117"
"Sublette",2016,"1","109","0","0","2","111"
"Sublette",2016,"2","127","2","1","3","133"
"Sublette",2016,"3","136","2","1","1","140"
"Sublette",2016,"4","136","2","1","0","139"
"Sublette",2016,"5","130","1","2","0","133"
"Sublette",2016,"6","115","5","1","0","121"
"Sublette",2016,"7","134","5","1","1","141"
"Sublette",2016,"8","157","4","1","0","162"
"Sublette",2016,"9","143","1","2","3","149"
"Sublette",2016,"10","113","2","1","0","116"
"Sublette",2016,"11","117","2","1","1","121"
"Sublette",2016,"12","118","2","3","2","125"
"Sublette",2016,"13","124","1","1","1","127"
"Sublette",2016,"14","124","3","1","12","140"
"Sublette",2016,"15","105","1","2","15","123"
"Sublette",2016,"16","115","3","2","3","123"
"Sublette",2016,"17","133","1","4","1","139"
"Sublette",2016,"18 to 20","255","3","8","1","267"
"Sublette",2016,"21 to 24","333","5","8","4","350"
"Sublette",2016,"25 & over","6569","91","71","61","6792"
"Sublette",2016,"Total","9403","139","114","113","9769"
"Campbell",2001,"0","494","3","16","4","517"
"Campbell",2001,"1","529","4","11","3","547"
"Campbell",2001,"2","525","4","9","2","540"
"Campbell",2001,"3","517","6","7","0","530"
"Campbell",2001,"4","477","5","7","0","489"
"Campbell",2001,"5","513","2","9","1","525"
"Campbell",2001,"6","508","6","9","3","526"
"Campbell",2001,"7","545","6","12","3","566"
"Campbell",2001,"8","527","7","11","2","547"
"Campbell",2001,"9","553","5","5","4","567"
"Campbell",2001,"10","584","3","8","3","598"
"Campbell",2001,"11","576","1","6","3","586"
"Campbell",2001,"12","607","0","7","4","618"
"Campbell",2001,"13","621","2","13","2","638"
"Campbell",2001,"14","640","3","10","5","658"
"Campbell",2001,"15","658","0","10","4","672"
"Campbell",2001,"16","728","2","10","3","743"
"Campbell",2001,"17","688","2","10","3","703"
"Campbell",2001,"18 to 20","1504","7","22","5","1538"
"Campbell",2001,"21 to 24","1780","3","36","13","1832"
"Campbell",2001,"25 & over","20413","39","212","95","20759"
"Campbell",2001,"Total","33987","110","440","162","34699"
"Converse",2002,"0","123","0","2","1","126"
"Converse",2002,"1","138","2","3","0","143"
"Converse",2002,"2","160","1","1","0","162"
"Converse",2002,"3","141","1","3","0","145"
"Converse",2002,"4","152","2","5","0","159"
"Converse",2002,"5","162","3","2","0","167"
"Converse",2002,"6","181","0","1","0","182"
"Converse",2002,"7","167","3","4","1","175"
"Converse",2002,"8","159","1","1","0","161"
"Converse",2002,"9","170","2","2","1","175"
"Converse",2002,"10","205","4","2","1","212"
"Converse",2002,"11","200","2","3","0","205"
"Converse",2002,"12","191","3","3","0","197"
"Converse",2002,"13","193","1","1","2","197"
"Converse",2002,"14","201","3","3","1","208"
"Converse",2002,"15","228","0","0","1","229"
"Converse",2002,"16","237","0","3","1","241"
"Converse",2002,"17","218","3","3","2","226"
"Converse",2002,"18 to 20","468","1","6","3","478"
"Converse",2002,"21 to 24","458","0","6","1","465"
"Converse",2002,"25 & over","7839","8","74","22","7943"
"Converse",2002,"Total","11991","40","128","37","12196"
"Fremont",1990,"0","358","1","168","1","528"
"Fremont",1990,"1","326","6","177","0","509"
"Fremont",1990,"2","357","0","159","4","520"
"Fremont",1990,"3","393","0","160","0","553"
"Fremont",1990,"4","426","0","168","6","600"
"Fremont",1990,"5","442","1","183","4","630"
"Fremont",1990,"6","461","0","165","0","626"
"Fremont",1990,"7","467","0","175","2","644"
"Fremont",1990,"8","456","0","167","2","625"
"Fremont",1990,"9","511","0","170","2","683"
"Fremont",1990,"10","488","3","180","3","674"
"Fremont",1990,"11","454","0","169","2","625"
"Fremont",1990,"12","472","0","127","0","599"
"Fremont",1990,"13","468","4","126","0","598"
"Fremont",1990,"14","423","0","109","0","532"
"Fremont",1990,"15","425","0","114","2","541"
"Fremont",1990,"16","417","2","116","2","537"
"Fremont",1990,"17","402","0","132","1","535"
"Fremont",1990,"18 to 20","867","3","321","5","1196"
"Fremont",1990,"21 to 24","963","4","415","7","1389"
"Fremont",1990,"25 & over","17539","18","2815","49","20421"
"Fremont",1990,"Total","27115","42","6316","92","33565"
"Park",2000,"0","269","1","2","1","273"
"Park",2000,"1","263","1","1","3","268"
"Park",2000,"2","300","2","7","1","310"
"Park",2000,"3","286","1","1","1","289"
"Park",2000,"4","279","1","1","4","285"
"Park",2000,"5","274","0","1","0","275"
"Park",2000,"6","281","1","2","0","284"
"Park",2000,"7","308","2","1","2","313"
"Park",2000,"8","348","2","1","1","352"
"Park",2000,"9","351","2","2","1","356"
"Park",2000,"10","347","2","2","2","353"
"Park",2000,"11","372","0","2","2","376"
"Park",2000,"12","394","0","4","4","402"
"Park",2000,"13","412","4","2","1","419"
"Park",2000,"14","396","1","1","3","401"
"Park",2000,"15","464","2","1","4","471"
"Park",2000,"16","407","0","3","5","415"
"Park",2000,"17","449","0","2","4","455"
"Park",2000,"18 to 20","1339","0","13","9","1361"
"Park",2000,"21 to 24","985","2","6","6","999"
"Park",2000,"25 & over","16992","16","79","77","17164"
"Park",2000,"Total","25516","40","134","131","25821"
"Carbon",2005,"0","174","3","5","2","184"
"Carbon",2005,"1","167","3","3","0","173"
"Carbon",2005,"2","176","3","1","2","182"
"Carbon",2005,"3","158","3","3","4","168"
"Carbon",2005,"4","168","5","1","1","175"
"Carbon",2005,"5","162","5","2","3","172"
"Carbon",2005,"6","189","4","3","1","197"
"Carbon",2005,"7","169","3","2","1","175"
"Carbon",2005,"8","183","0","5","3","191"
"Carbon",2005,"9","163","2","3","2","170"
"Carbon",2005,"10","177","3","4","2","186"
"Carbon",2005,"11","177","1","3","1","182"
"Carbon",2005,"12","168","1","1","2","172"
"Carbon",2005,"13","183","2","4","1","190"
"Carbon",2005,"14","194","2","3","2","201"
"Carbon",2005,"15","197","1","5","2","205"
"Carbon",2005,"16","208","2","3","2","215"
"Carbon",2005,"17","197","1","4","3","205"
"Carbon",2005,"18 to 20","528","7","7","5","547"
"Carbon",2005,"21 to 24","763","7","16","7","793"
"Carbon",2005,"25 & over","10096","82","127","89","10394"
"Carbon",2005,"Total","14597","140","205","135","15077"
"Laramie",1992,"0","1099","46","17","18","1180"
"Laramie",1992,"1","1062","40","8","17","1127"
"Laramie",1992,"2","1098","58","12","13","1181"
"Laramie",1992,"3","1068","70","11","19","1168"
"Laramie",1992,"4","1024","63","13","14","1114"
"Laramie",1992,"5","1083","65","9","11","1168"
"Laramie",1992,"6","1073","45","14","15","1147"
"Laramie",1992,"7","1128","46","10","16","1200"
"Laramie",1992,"8","1080","49","8","14","1151"
"Laramie",1992,"9","1164","58","16","11","1249"
"Laramie",1992,"10","1179","43","19","14","1255"
"Laramie",1992,"11","1152","54","14","19","1239"
"Laramie",1992,"12","1152","52","19","9","1232"
"Laramie",1992,"13","1105","31","12","13","1161"
"Laramie",1992,"14","1061","35","17","13","1126"
"Laramie",1992,"15","1093","52","5","14","1164"
"Laramie",1992,"16","1028","33","8","12","1081"
"Laramie",1992,"17","1054","37","8","20","1119"
"Laramie",1992,"18 to 20","2974","153","40","48","3215"
"Laramie",1992,"21 to 24","4035","207","41","78","4361"
"Laramie",1992,"25 & over","45156","1189","349","494","47188"
"Laramie",1992,"Total","71868","2426","650","882","75826"
"Albany",2001,"0","369","10","8","6","393"
"Albany",2001,"1","293","12","2","11","318"
"Albany",2001,"2","292","17","3","10","322"
"Albany",2001,"3","294","9","5","4","312"
"Albany",2001,"4","284","8","5","7","304"
"Albany",2001,"5","279","8","3","8","298"
"Albany",2001,"6","294","5","8","6","313"
"Albany",2001,"7","259","8","5","5","277"
"Albany",2001,"8","294","6","3","6","309"
"Albany",2001,"9","280","8","4","6","298"
"Albany",2001,"10","286","8","7","7","308"
"Albany",2001,"11","307","9","4","9","329"
"Albany",2001,"12","269","7","7","6","289"
"Albany",2001,"13","290","6","6","9","311"
"Albany",2001,"14","310","6","5","3","324"
"Albany",2001,"15","321","6","7","3","337"
"Albany",2001,"16","327","3","10","2","342"
"Albany",2001,"17","355","6","5","3","369"
"Albany",2001,"18 to 20","4287","62","46","69","4464"
"Albany",2001,"21 to 24","5223","119","63","125","5530"
"Albany",2001,"25 & over","15939","159","208","366","16672"
"Albany",2001,"Total","30852","482","414","671","32419"
"Big Horn",1997,"0","155","0","0","0","155"
"Big Horn",1997,"1","148","0","2","0","150"
"Big Horn",1997,"2","162","0","0","0","162"
"Big Horn",1997,"3","144","0","0","0","144"
"Big Horn",1997,"4","151","0","3","0","154"
"Big Horn",1997,"5","162","0","4","2","168"
"Big Horn",1997,"6","167","0","0","0","167"
"Big Horn",1997,"7","168","0","0","0","168"
"Big Horn",1997,"8","173","0","0","0","173"
"Big Horn",1997,"9","199","0","0","0","199"
"Big Horn",1997,"10","183","0","6","1","190"
"Big Horn",1997,"11","184","0","1","0","185"
"Big Horn",1997,"12","230","0","3","0","233"
"Big Horn",1997,"13","206","0","0","0","206"
"Big Horn",1997,"14","216","0","0","1","217"
"Big Horn",1997,"15","199","0","5","0","204"
"Big Horn",1997,"16","230","0","0","0","230"
"Big Horn",1997,"17","224","0","2","2","228"
"Big Horn",1997,"18 to 20","404","0","5","0","409"
"Big Horn",1997,"21 to 24","391","0","0","0","391"
"Big Horn",1997,"25 & over","7075","0","37","10","7122"
"Big Horn",1997,"Total","11171","0","68","16","11255"
"Sheridan",1994,"0","266","0","2","0","268"
"Sheridan",1994,"1","261","1","4","4","270"
"Sheridan",1994,"2","278","0","4","0","282"
"Sheridan",1994,"3","286","0","4","0","290"
"Sheridan",1994,"4","292","0","8","3","303"
"Sheridan",1994,"5","307","2","7","2","318"
"Sheridan",1994,"6","329","0","4","2","335"
"Sheridan",1994,"7","358","0","2","0","360"
"Sheridan",1994,"8","338","0","7","0","345"
"Sheridan",1994,"9","373","0","4","0","377"
"Sheridan",1994,"10","399","0","4","1","404"
"Sheridan",1994,"11","403","0","4","1","408"
"Sheridan",1994,"12","426","3","7","0","436"
"Sheridan",1994,"13","412","2","2","0","416"
"Sheridan",1994,"14","444","0","12","7","463"
"Sheridan",1994,"15","438","1","11","1","451"
"Sheridan",1994,"16","401","0","6","4","411"
"Sheridan",1994,"17","434","0","2","6","442"
"Sheridan",1994,"18 to 20","970","11","12","0","993"
"Sheridan",1994,"21 to 24","891","0","19","10","920"
"Sheridan",1994,"25 & over","16553","10","146","55","16764"
"Sheridan",1994,"Total","24859","30","271","96","25256"
"Goshen",2011,"0","113","2","3","0","118"
"Goshen",2011,"1","141","1","4","1","147"
"Goshen",2011,"2","146","1","2","2","151"
"Goshen",2011,"3","137","5","0","3","145"
"Goshen",2011,"4","163","3","3","0","169"
"Goshen",2011,"5","114","3","1","1","119"
"Goshen",2011,"6","125","1","1","0","127"
"Goshen",2011,"7","136","1","1","6","144"
"Goshen",2011,"8","142","1","3","2","148"
"Goshen",2011,"9","137","2","0","0","139"
"Goshen",2011,"10","158","2","2","1","163"
"Goshen",2011,"11","158","3","2","1","164"
"Goshen",2011,"12","149","2","0","1","152"
"Goshen",2011,"13","150","2","4","1","157"
"Goshen",2011,"14","175","0","2","2","179"
"Goshen",2011,"15","155","6","1","1","163"
"Goshen",2011,"16","146","2","3","0","151"
"Goshen",2011,"17","176","2","3","0","181"
"Goshen",2011,"18 to 20","646","18","11","5","680"
"Goshen",2011,"21 to 24","705","12","9","4","730"
"Goshen",2011,"25 & over","9289","66","69","41","9465"
"Goshen",2011,"Total","13261","135","124","72","13592"
"Sweetwater",1991,"0","564","2","8","3","577"
"Sweetwater",1991,"1","622","8","6","5","641"
"Sweetwater",1991,"2","618","5","12","2","637"
"Sweetwater",1991,"3","624","10","6","2","642"
"Sweetwater",1991,"4","644","8","6","2","660"
"Sweetwater",1991,"5","669","5","5","5","684"
"Sweetwater",1991,"6","745","9","11","4","769"
"Sweetwater",1991,"7","782","4","9","6","801"
"Sweetwater",1991,"8","755","1","4","4","764"
"Sweetwater",1991,"9","895","1","8","5","909"
"Sweetwater",1991,"10","858","8","10","1","877"
"Sweetwater",1991,"11","855","5","4","6","870"
"Sweetwater",1991,"12","821","4","7","2","834"
"Sweetwater",1991,"13","818","5","7","4","834"
"Sweetwater",1991,"14","741","8","9","2","760"
"Sweetwater",1991,"15","681","5","7","2","695"
"Sweetwater",1991,"16","720","8","9","6","743"
"Sweetwater",1991,"17","673","6","4","7","690"
"Sweetwater",1991,"18 to 20","1590","19","10","12","1631"
"Sweetwater",1991,"21 to 24","1566","19","15","10","1610"
"Sweetwater",1991,"25 & over","22467","160","178","159","22964"
"Sweetwater",1991,"Total","38708","300","335","249","39592"
"Washakie",1993,"0","101","0","0","1","102"
"Washakie",1993,"1","105","0","2","0","107"
"Washakie",1993,"2","110","0","0","2","112"
"Washakie",1993,"3","107","0","0","0","107"
"Washakie",1993,"4","106","0","0","0","106"
"Washakie",1993,"5","113","1","3","1","118"
"Washakie",1993,"6","115","0","0","1","116"
"Washakie",1993,"7","127","0","0","0","127"
"Washakie",1993,"8","149","0","0","0","149"
"Washakie",1993,"9","162","0","0","0","162"
"Washakie",1993,"10","171","0","0","1","172"
"Washakie",1993,"11","174","0","0","0","174"
"Washakie",1993,"12","155","0","3","1","159"
"Washakie",1993,"13","164","0","2","0","166"
"Washakie",1993,"14","159","0","3","0","162"
"Washakie",1993,"15","169","0","6","0","175"
"Washakie",1993,"16","145","0","0","0","145"
"Washakie",1993,"17","134","0","0","1","135"
"Washakie",1993,"18 to 20","267","1","1","0","269"
"Washakie",1993,"21 to 24","276","0","0","0","276"
"Washakie",1993,"25 & over","5377","1","18","17","5413"
"Washakie",1993,"Total","8386","3","38","25","8452"
"Lincoln",2002,"0","202","0","4","0","206"
"Lincoln",2002,"1","167","0","1","1","169"
"Lincoln",2002,"2","215","1","4","1","221"
"Lincoln",2002,"3","195","0","0","2","197"
"Lincoln",2002,"4","214","0","2","0","216"
"Lincoln",2002,"5","195","1","3","0","199"
"Lincoln",2002,"6","214","0","3","1","218"
"Lincoln",2002,"7","191","0","1","0","192"
"Lincoln",2002,"8","245","1","2","0","248"
"Lincoln",2002,"9","245","2","0","0","247"
"Lincoln",2002,"10","249","2","3","0","254"
"Lincoln",2002,"11","284","4","5","0","293"
"Lincoln",2002,"12","235","4","1","2","242"
"Lincoln",2002,"13","280","0","2","0","282"
"Lincoln",2002,"14","270","1","1","2","274"
"Lincoln",2002,"15","293","0","1","0","294"
"Lincoln",2002,"16","287","0","1","3","291"
"Lincoln",2002,"17","301","2","2","0","305"
"Lincoln",2002,"18 to 20","619","2","4","3","628"
"Lincoln",2002,"21 to 24","528","2","3","0","533"
"Lincoln",2002,"25 & over","9239","11","64","35","9349"
"Lincoln",2002,"Total","14668","33","107","50","14858"
"Teton",2009,"0","261","2","2","2","267"
"Teton",2009,"1","287","3","3","1","294"
"Teton",2009,"2","252","2","3","3","260"
"Teton",2009,"3","284","1","2","3","290"
"Teton",2009,"4","198","3","4","4","209"
"Teton",2009,"5","209","1","3","2","215"
"Teton",2009,"6","207","3","2","2","214"
"Teton",2009,"7","205","1","2","6","214"
"Teton",2009,"8","197","2","3","5","207"
"Teton",2009,"9","167","0","1","7","175"
"Teton",2009,"10","230","2","4","8","244"
"Teton",2009,"11","174","2","2","1","179"
"Teton",2009,"12","216","3","2","7","228"
"Teton",2009,"13","190","1","1","2","194"
"Teton",2009,"14","201","1","1","9","212"
"Teton",2009,"15","236","1","2","6","245"
"Teton",2009,"16","184","0","2","3","189"
"Teton",2009,"17","210","2","5","2","219"
"Teton",2009,"18 to 20","426","7","6","11","450"
"Teton",2009,"21 to 24","1252","5","16","18","1291"
"Teton",2009,"25 & over","15067","53","122","194","15436"
"Teton",2009,"Total","20653","95","188","296","21232"
"Teton",1996,"0","190","0","1","2","193"
"Teton",1996,"1","172","2","0","1","175"
"Teton",1996,"2","177","0","2","0","179"
"Teton",1996,"3","180","0","0","1","181"
"Teton",1996,"4","163","0","3","0","166"
"Teton",1996,"5","172","0","2","0","174"
"Teton",1996,"6","167","0","0","0","167"
"Teton",1996,"7","169","3","1","0","173"
"Teton",1996,"8","181","0","0","2","183"
"Teton",1996,"9","181","1","0","0","182"
"Teton",1996,"10","204","2","2","0","208"
"Teton",1996,"11","201","0","0","0","201"
"Teton",1996,"12","187","0","0","0","187"
"Teton",1996,"13","211","0","0","0","211"
"Teton",1996,"14","196","0","2","3","201"
"Teton",1996,"15","180","1","3","1","185"
"Teton",1996,"16","202","0","3","0","205"
"Teton",1996,"17","181","0","0","0","181"
"Teton",1996,"18 to 20","428","1","6","0","435"
"Teton",1996,"21 to 24","954","3","3","6","966"
"Teton",1996,"25 & over","10644","8","54","35","10741"
"Teton",1996,"Total","15340","21","82","51","15494"
"Campbell",2014,"0","706","11","18","6","741"
"Campbell",2014,"1","700","16","25","11","752"
"Campbell",2014,"2","730","13","17","8","768"
"Campbell",2014,"3","687","12","25","5","729"
"Campbell",2014,"4","844","13","16","10","883"
"Campbell",2014,"5","775","9","17","8","809"
"Campbell",2014,"6","845","11","12","0","868"
"Campbell",2014,"7","818","14","19","0","851"
"Campbell",2014,"8","753","8","15","4","780"
"Campbell",2014,"9","734","5","14","5","758"
"Campbell",2014,"10","751","8","15","4","778"
"Campbell",2014,"11","665","8","15","8","696"
"Campbell",2014,"12","636","12","14","3","665"
"Campbell",2014,"13","672","8","14","4","698"
"Campbell",2014,"14","700","9","26","9","744"
"Campbell",2014,"15","659","4","16","6","685"
"Campbell",2014,"16","667","12","15","3","697"
"Campbell",2014,"17","639","6","16","3","664"
"Campbell",2014,"18 to 20","1485","40","41","8","1574"
"Campbell",2014,"21 to 24","2566","54","64","26","2710"
"Campbell",2014,"25 & over","29456","218","458","259","30391"
"Campbell",2014,"Total","46488","491","872","390","48241"
"Sweetwater",1992,"0","558","4","8","2","572"
"Sweetwater",1992,"1","594","4","8","6","612"
"Sweetwater",1992,"2","625","8","10","1","644"
"Sweetwater",1992,"3","617","10","7","1","635"
"Sweetwater",1992,"4","613","9","6","1","629"
"Sweetwater",1992,"5","639","9","5","5","658"
"Sweetwater",1992,"6","714","8","9","2","733"
"Sweetwater",1992,"7","772","2","12","4","790"
"Sweetwater",1992,"8","728","1","4","5","738"
"Sweetwater",1992,"9","874","3","8","6","891"
"Sweetwater",1992,"10","849","4","11","1","865"
"Sweetwater",1992,"11","842","7","6","4","859"
"Sweetwater",1992,"12","865","5","6","3","879"
"Sweetwater",1992,"13","842","5","9","3","859"
"Sweetwater",1992,"14","765","7","8","1","781"
"Sweetwater",1992,"15","722","8","9","2","741"
"Sweetwater",1992,"16","722","7","10","5","744"
"Sweetwater",1992,"17","718","5","5","4","732"
"Sweetwater",1992,"18 to 20","1659","17","10","17","1703"
"Sweetwater",1992,"21 to 24","1653","22","14","8","1697"
"Sweetwater",1992,"25 & over","22746","167","183","154","23250"
"Sweetwater",1992,"Total","39117","312","348","235","40012"
"Johnson",2011,"0","93","3","7","0","103"
"Johnson",2011,"1","91","0","8","2","101"
"Johnson",2011,"2","108","1","5","1","115"
"Johnson",2011,"3","113","1","4","3","121"
"Johnson",2011,"4","118","0","3","0","121"
"Johnson",2011,"5","116","2","3","0","121"
"Johnson",2011,"6","122","1","2","1","126"
"Johnson",2011,"7","104","2","2","0","108"
"Johnson",2011,"8","90","1","2","0","93"
"Johnson",2011,"9","94","2","1","0","97"
"Johnson",2011,"10","91","1","0","0","92"
"Johnson",2011,"11","103","2","1","0","106"
"Johnson",2011,"12","90","0","1","0","91"
"Johnson",2011,"13","97","0","1","0","98"
"Johnson",2011,"14","102","2","0","1","105"
"Johnson",2011,"15","93","0","1","0","94"
"Johnson",2011,"16","120","0","2","0","122"
"Johnson",2011,"17","105","4","1","2","112"
"Johnson",2011,"18 to 20","220","4","4","1","229"
"Johnson",2011,"21 to 24","262","3","5","3","273"
"Johnson",2011,"25 & over","6085","34","54","31","6204"
"Johnson",2011,"Total","8417","63","107","45","8632"
"Laramie",1994,"0","1080","45","11","15","1151"
"Laramie",1994,"1","1046","44","9","22","1121"
"Laramie",1994,"2","1043","40","13","26","1122"
"Laramie",1994,"3","1055","41","10","15","1121"
"Laramie",1994,"4","1058","60","19","12","1149"
"Laramie",1994,"5","1070","60","12","16","1158"
"Laramie",1994,"6","1037","55","17","14","1123"
"Laramie",1994,"7","1111","54","7","10","1182"
"Laramie",1994,"8","1093","43","7","18","1161"
"Laramie",1994,"9","1165","56","14","15","1250"
"Laramie",1994,"10","1166","51","16","17","1250"
"Laramie",1994,"11","1201","49","17","19","1286"
"Laramie",1994,"12","1202","34","16","11","1263"
"Laramie",1994,"13","1214","36","12","17","1279"
"Laramie",1994,"14","1198","53","27","16","1294"
"Laramie",1994,"15","1171","46","7","13","1237"
"Laramie",1994,"16","1134","25","8","9","1176"
"Laramie",1994,"17","1112","39","9","19","1179"
"Laramie",1994,"18 to 20","3085","135","43","47","3310"
"Laramie",1994,"21 to 24","4329","192","56","94","4671"
"Laramie",1994,"25 & over","47304","1188","373","537","49402"
"Laramie",1994,"Total","74874","2346","703","962","78885"
"Sheridan",2012,"0","318","3","10","6","337"
"Sheridan",2012,"1","322","6","7","10","345"
"Sheridan",2012,"2","345","5","7","2","359"
"Sheridan",2012,"3","321","2","9","1","333"
"Sheridan",2012,"4","378","4","10","5","397"
"Sheridan",2012,"5","364","8","8","2","382"
"Sheridan",2012,"6","353","2","6","1","362"
"Sheridan",2012,"7","327","5","5","3","340"
"Sheridan",2012,"8","342","4","7","2","355"
"Sheridan",2012,"9","366","6","4","2","378"
"Sheridan",2012,"10","327","6","8","1","342"
"Sheridan",2012,"11","320","5","9","3","337"
"Sheridan",2012,"12","362","4","13","1","380"
"Sheridan",2012,"13","342","4","8","3","357"
"Sheridan",2012,"14","349","2","12","2","365"
"Sheridan",2012,"15","358","7","7","2","374"
"Sheridan",2012,"16","323","5","10","3","341"
"Sheridan",2012,"17","341","7","9","2","359"
"Sheridan",2012,"18 to 20","1080","31","41","15","1167"
"Sheridan",2012,"21 to 24","1178","23","30","13","1244"
"Sheridan",2012,"25 & over","20116","192","241","177","20726"
"Sheridan",2012,"Total","28532","331","461","256","29580"
"Sublette",1993,"0","62","0","0","0","62"
"Sublette",1993,"1","70","0","3","2","75"
"Sublette",1993,"2","69","0","0","0","69"
"Sublette",1993,"3","74","0","0","0","74"
"Sublette",1993,"4","75","0","0","0","75"
"Sublette",1993,"5","64","0","3","0","67"
"Sublette",1993,"6","68","0","0","0","68"
"Sublette",1993,"7","83","0","0","0","83"
"Sublette",1993,"8","78","0","3","0","81"
"Sublette",1993,"9","79","0","0","0","79"
"Sublette",1993,"10","81","0","7","0","88"
"Sublette",1993,"11","105","0","0","0","105"
"Sublette",1993,"12","87","0","0","0","87"
"Sublette",1993,"13","96","0","0","0","96"
"Sublette",1993,"14","81","0","0","0","81"
"Sublette",1993,"15","86","0","0","0","86"
"Sublette",1993,"16","85","0","0","0","85"
"Sublette",1993,"17","74","0","0","0","74"
"Sublette",1993,"18 to 20","149","0","0","0","149"
"Sublette",1993,"21 to 24","173","0","5","0","178"
"Sublette",1993,"25 & over","3396","2","22","2","3422"
"Sublette",1993,"Total","5135","2","43","4","5184"
"Converse",2006,"0","143","1","8","1","153"
"Converse",2006,"1","155","4","1","1","161"
"Converse",2006,"2","143","1","2","0","146"
"Converse",2006,"3","171","4","2","2","179"
"Converse",2006,"4","161","2","3","0","166"
"Converse",2006,"5","168","4","1","1","174"
"Converse",2006,"6","169","1","3","0","173"
"Converse",2006,"7","153","1","3","1","158"
"Converse",2006,"8","151","0","2","0","153"
"Converse",2006,"9","149","3","1","1","154"
"Converse",2006,"10","186","2","1","2","191"
"Converse",2006,"11","181","4","1","0","186"
"Converse",2006,"12","157","5","1","0","163"
"Converse",2006,"13","197","2","2","0","201"
"Converse",2006,"14","203","5","3","1","212"
"Converse",2006,"15","191","1","0","1","193"
"Converse",2006,"16","249","2","4","1","256"
"Converse",2006,"17","204","4","2","1","211"
"Converse",2006,"18 to 20","470","2","3","0","475"
"Converse",2006,"21 to 24","575","3","4","2","584"
"Converse",2006,"25 & over","8380","23","80","29","8512"
"Converse",2006,"Total","12556","74","127","44","12801"
"Johnson",2002,"0","67","1","3","0","71"
"Johnson",2002,"1","73","0","1","0","74"
"Johnson",2002,"2","61","0","2","0","63"
"Johnson",2002,"3","79","0","0","0","79"
"Johnson",2002,"4","73","1","1","1","76"
"Johnson",2002,"5","92","0","2","0","94"
"Johnson",2002,"6","79","2","1","0","82"
"Johnson",2002,"7","104","0","3","0","107"
"Johnson",2002,"8","86","2","2","0","90"
"Johnson",2002,"9","98","0","1","0","99"
"Johnson",2002,"10","98","0","2","0","100"
"Johnson",2002,"11","100","0","0","0","100"
"Johnson",2002,"12","111","0","1","0","112"
"Johnson",2002,"13","104","0","1","0","105"
"Johnson",2002,"14","97","0","2","0","99"
"Johnson",2002,"15","106","0","0","1","107"
"Johnson",2002,"16","113","0","0","0","113"
"Johnson",2002,"17","105","0","0","0","105"
"Johnson",2002,"18 to 20","260","0","2","3","265"
"Johnson",2002,"21 to 24","204","2","2","0","208"
"Johnson",2002,"25 & over","5180","6","30","6","5222"
"Johnson",2002,"Total","7290","14","56","11","7371"
"Lincoln",2006,"0","272","0","1","1","274"
"Lincoln",2006,"1","240","2","2","1","245"
"Lincoln",2006,"2","202","1","4","0","207"
"Lincoln",2006,"3","238","0","1","1","240"
"Lincoln",2006,"4","250","1","3","2","256"
"Lincoln",2006,"5","226","1","2","2","231"
"Lincoln",2006,"6","255","1","3","0","259"
"Lincoln",2006,"7","258","0","5","0","263"
"Lincoln",2006,"8","229","3","3","0","235"
"Lincoln",2006,"9","259","1","3","0","263"
"Lincoln",2006,"10","253","2","5","1","261"
"Lincoln",2006,"11","243","3","3","1","250"
"Lincoln",2006,"12","272","2","1","1","276"
"Lincoln",2006,"13","262","2","3","1","268"
"Lincoln",2006,"14","253","2","3","0","258"
"Lincoln",2006,"15","283","2","4","1","290"
"Lincoln",2006,"16","243","2","2","1","248"
"Lincoln",2006,"17","308","0","6","0","314"
"Lincoln",2006,"18 to 20","510","2","3","1","516"
"Lincoln",2006,"21 to 24","662","2","7","1","672"
"Lincoln",2006,"25 & over","10466","16","81","40","10603"
"Lincoln",2006,"Total","16184","45","145","55","16429"
"Uinta",1991,"0","343","1","1","0","345"
"Uinta",1991,"1","389","3","2","1","395"
"Uinta",1991,"2","342","0","2","0","344"
"Uinta",1991,"3","341","0","0","3","344"
"Uinta",1991,"4","374","2","2","3","381"
"Uinta",1991,"5","403","3","2","2","410"
"Uinta",1991,"6","468","2","1","3","474"
"Uinta",1991,"7","429","0","6","3","438"
"Uinta",1991,"8","448","1","1","0","450"
"Uinta",1991,"9","461","0","2","4","467"
"Uinta",1991,"10","471","2","4","5","482"
"Uinta",1991,"11","472","0","4","0","476"
"Uinta",1991,"12","447","0","4","0","451"
"Uinta",1991,"13","445","0","5","2","452"
"Uinta",1991,"14","442","0","2","0","444"
"Uinta",1991,"15","401","1","5","0","407"
"Uinta",1991,"16","414","0","2","2","418"
"Uinta",1991,"17","353","0","3","1","357"
"Uinta",1991,"18 to 20","665","0","3","6","674"
"Uinta",1991,"21 to 24","690","0","10","0","700"
"Uinta",1991,"25 & over","10100","3","62","27","10192"
"Uinta",1991,"Total","18898","18","123","62","19101"
"Converse",2005,"0","159","1","5","0","165"
"Converse",2005,"1","119","4","1","1","125"
"Converse",2005,"2","177","1","2","0","180"
"Converse",2005,"3","157","3","4","2","166"
"Converse",2005,"4","158","3","6","0","167"
"Converse",2005,"5","163","5","2","1","171"
"Converse",2005,"6","170","1","2","0","173"
"Converse",2005,"7","144","1","4","1","150"
"Converse",2005,"8","145","0","0","0","145"
"Converse",2005,"9","177","3","1","0","181"
"Converse",2005,"10","178","2","1","2","183"
"Converse",2005,"11","164","3","2","0","169"
"Converse",2005,"12","174","4","1","0","179"
"Converse",2005,"13","204","2","2","1","209"
"Converse",2005,"14","189","5","4","2","200"
"Converse",2005,"15","204","1","0","0","205"
"Converse",2005,"16","225","0","2","1","228"
"Converse",2005,"17","199","3","3","1","206"
"Converse",2005,"18 to 20","489","1","2","1","493"
"Converse",2005,"21 to 24","560","2","5","1","568"
"Converse",2005,"25 & over","8208","22","73","29","8332"
"Converse",2005,"Total","12363","67","122","43","12595"
"Lincoln",1997,"0","197","0","2","0","199"
"Lincoln",1997,"1","208","0","2","1","211"
"Lincoln",1997,"2","201","0","2","1","204"
"Lincoln",1997,"3","194","0","0","1","195"
"Lincoln",1997,"4","199","0","0","1","200"
"Lincoln",1997,"5","211","2","0","0","213"
"Lincoln",1997,"6","238","0","0","1","239"
"Lincoln",1997,"7","252","0","0","0","252"
"Lincoln",1997,"8","253","0","3","0","256"
"Lincoln",1997,"9","279","0","2","0","281"
"Lincoln",1997,"10","239","1","7","1","248"
"Lincoln",1997,"11","302","0","0","0","302"
"Lincoln",1997,"12","297","0","2","0","299"
"Lincoln",1997,"13","312","0","1","0","313"
"Lincoln",1997,"14","303","0","0","0","303"
"Lincoln",1997,"15","327","3","2","0","332"
"Lincoln",1997,"16","315","0","0","0","315"
"Lincoln",1997,"17","329","0","0","0","329"
"Lincoln",1997,"18 to 20","525","3","6","0","534"
"Lincoln",1997,"21 to 24","447","0","0","0","447"
"Lincoln",1997,"25 & over","8377","2","27","21","8427"
"Lincoln",1997,"Total","14005","11","56","27","14099"
"Niobrara",1990,"0","34","0","0","0","34"
"Niobrara",1990,"1","24","0","0","0","24"
"Niobrara",1990,"2","30","0","0","0","30"
"Niobrara",1990,"3","30","0","0","0","30"
"Niobrara",1990,"4","26","0","0","0","26"
"Niobrara",1990,"5","34","0","0","0","34"
"Niobrara",1990,"6","31","0","0","0","31"
"Niobrara",1990,"7","41","0","0","0","41"
"Niobrara",1990,"8","38","0","0","0","38"
"Niobrara",1990,"9","33","0","0","0","33"
"Niobrara",1990,"10","32","0","0","0","32"
"Niobrara",1990,"11","38","0","0","0","38"
"Niobrara",1990,"12","32","0","0","0","32"
"Niobrara",1990,"13","38","0","0","0","38"
"Niobrara",1990,"14","36","0","0","0","36"
"Niobrara",1990,"15","38","0","0","0","38"
"Niobrara",1990,"16","37","0","0","0","37"
"Niobrara",1990,"17","34","0","0","0","34"
"Niobrara",1990,"18 to 20","64","2","0","0","66"
"Niobrara",1990,"21 to 24","71","0","0","0","71"
"Niobrara",1990,"25 & over","1737","2","4","0","1743"
"Niobrara",1990,"Total","2478","4","4","0","2486"
"Platte",2015,"0","82","1","0","2","85"
"Platte",2015,"1","81","3","0","1","85"
"Platte",2015,"2","86","2","2","1","91"
"Platte",2015,"3","117","2","2","2","123"
"Platte",2015,"4","96","2","0","1","99"
"Platte",2015,"5","83","1","1","1","86"
"Platte",2015,"6","102","2","1","0","105"
"Platte",2015,"7","98","1","1","0","100"
"Platte",2015,"8","97","4","1","3","105"
"Platte",2015,"9","89","0","2","1","92"
"Platte",2015,"10","98","0","0","0","98"
"Platte",2015,"11","86","1","0","0","87"
"Platte",2015,"12","95","2","2","1","100"
"Platte",2015,"13","109","1","1","0","111"
"Platte",2015,"14","96","1","1","0","98"
"Platte",2015,"15","104","0","3","2","109"
"Platte",2015,"16","101","0","0","0","101"
"Platte",2015,"17","93","3","1","2","99"
"Platte",2015,"18 to 20","248","4","2","4","258"
"Platte",2015,"21 to 24","347","5","4","5","361"
"Platte",2015,"25 & over","6276","56","47","33","6412"
"Platte",2015,"Total","8584","91","71","59","8805"
"Johnson",2006,"0","94","0","5","0","99"
"Johnson",2006,"1","101","1","3","1","106"
"Johnson",2006,"2","85","0","2","0","87"
"Johnson",2006,"3","63","1","1","0","65"
"Johnson",2006,"4","76","2","2","0","80"
"Johnson",2006,"5","94","0","2","1","97"
"Johnson",2006,"6","82","1","2","0","85"
"Johnson",2006,"7","88","0","1","0","89"
"Johnson",2006,"8","77","0","0","0","77"
"Johnson",2006,"9","84","0","1","0","85"
"Johnson",2006,"10","79","1","1","0","81"
"Johnson",2006,"11","113","0","1","0","114"
"Johnson",2006,"12","96","0","1","0","97"
"Johnson",2006,"13","113","0","0","1","114"
"Johnson",2006,"14","100","1","0","0","101"
"Johnson",2006,"15","119","2","1","0","122"
"Johnson",2006,"16","113","2","3","1","119"
"Johnson",2006,"17","108","1","0","0","109"
"Johnson",2006,"18 to 20","215","0","3","2","220"
"Johnson",2006,"21 to 24","292","1","4","4","301"
"Johnson",2006,"25 & over","5470","9","48","21","5548"
"Johnson",2006,"Total","7662","22","81","31","7796"
"Carbon",1992,"0","182","0","0","1","183"
"Carbon",1992,"1","205","0","3","1","209"
"Carbon",1992,"2","211","4","0","0","215"
"Carbon",1992,"3","202","0","6","0","208"
"Carbon",1992,"4","222","0","0","0","222"
"Carbon",1992,"5","247","2","5","0","254"
"Carbon",1992,"6","251","1","1","0","253"
"Carbon",1992,"7","258","1","0","1","260"
"Carbon",1992,"8","240","4","8","2","254"
"Carbon",1992,"9","266","1","0","4","271"
"Carbon",1992,"10","293","4","4","3","304"
"Carbon",1992,"11","296","2","6","0","304"
"Carbon",1992,"12","310","4","0","2","316"
"Carbon",1992,"13","275","0","0","0","275"
"Carbon",1992,"14","293","0","0","1","294"
"Carbon",1992,"15","272","1","0","1","274"
"Carbon",1992,"16","261","0","0","2","263"
"Carbon",1992,"17","287","0","0","1","288"
"Carbon",1992,"18 to 20","532","5","9","4","550"
"Carbon",1992,"21 to 24","662","3","11","4","680"
"Carbon",1992,"25 & over","10103","56","77","36","10272"
"Carbon",1992,"Total","15868","88","130","63","16149"
"Campbell",2012,"0","740","12","17","7","776"
"Campbell",2012,"1","663","16","24","5","708"
"Campbell",2012,"2","836","9","19","9","873"
"Campbell",2012,"3","781","9","23","5","818"
"Campbell",2012,"4","846","7","14","1","868"
"Campbell",2012,"5","798","10","22","1","831"
"Campbell",2012,"6","782","7","15","3","807"
"Campbell",2012,"7","742","7","13","4","766"
"Campbell",2012,"8","745","10","14","4","773"
"Campbell",2012,"9","670","7","19","7","703"
"Campbell",2012,"10","644","11","15","2","672"
"Campbell",2012,"11","692","9","15","3","719"
"Campbell",2012,"12","706","5","17","8","736"
"Campbell",2012,"13","670","6","12","4","692"
"Campbell",2012,"14","678","8","12","2","700"
"Campbell",2012,"15","637","5","13","2","657"
"Campbell",2012,"16","626","6","13","5","650"
"Campbell",2012,"17","629","6","8","5","648"
"Campbell",2012,"18 to 20","1578","61","62","10","1711"
"Campbell",2012,"21 to 24","2639","54","51","26","2770"
"Campbell",2012,"25 & over","29073","261","440","220","29994"
"Campbell",2012,"Total","46175","526","838","333","47872"
"Goshen",1997,"0","151","0","2","0","153"
"Goshen",1997,"1","144","0","5","0","149"
"Goshen",1997,"2","142","0","1","0","143"
"Goshen",1997,"3","154","0","1","0","155"
"Goshen",1997,"4","151","0","1","0","152"
"Goshen",1997,"5","136","2","3","0","141"
"Goshen",1997,"6","180","0","9","0","189"
"Goshen",1997,"7","141","0","1","0","142"
"Goshen",1997,"8","185","0","1","0","186"
"Goshen",1997,"9","191","0","3","0","194"
"Goshen",1997,"10","198","5","1","2","206"
"Goshen",1997,"11","188","0","7","0","195"
"Goshen",1997,"12","204","0","4","0","208"
"Goshen",1997,"13","205","0","0","0","205"
"Goshen",1997,"14","210","0","0","0","210"
"Goshen",1997,"15","225","0","4","0","229"
"Goshen",1997,"16","214","0","0","0","214"
"Goshen",1997,"17","206","0","4","0","210"
"Goshen",1997,"18 to 20","650","6","2","5","663"
"Goshen",1997,"21 to 24","518","0","0","2","520"
"Goshen",1997,"25 & over","8275","7","34","7","8323"
"Goshen",1997,"Total","12668","20","83","16","12787"
"Natrona",1993,"0","868","10","11","3","892"
"Natrona",1993,"1","880","10","9","7","906"
"Natrona",1993,"2","848","8","13","1","870"
"Natrona",1993,"3","919","15","12","7","953"
"Natrona",1993,"4","930","15","7","4","956"
"Natrona",1993,"5","921","13","9","3","946"
"Natrona",1993,"6","950","14","8","1","973"
"Natrona",1993,"7","1003","11","5","9","1028"
"Natrona",1993,"8","1031","10","12","4","1057"
"Natrona",1993,"9","1030","13","12","11","1066"
"Natrona",1993,"10","1141","16","16","7","1180"
"Natrona",1993,"11","1110","9","10","4","1133"
"Natrona",1993,"12","1066","11","13","8","1098"
"Natrona",1993,"13","1073","11","13","9","1106"
"Natrona",1993,"14","1003","9","10","5","1027"
"Natrona",1993,"15","1028","6","9","6","1049"
"Natrona",1993,"16","956","9","4","4","973"
"Natrona",1993,"17","963","11","6","5","985"
"Natrona",1993,"18 to 20","2762","57","27","15","2861"
"Natrona",1993,"21 to 24","2906","25","31","12","2974"
"Natrona",1993,"25 & over","39243","235","308","162","39948"
"Natrona",1993,"Total","62631","518","545","287","63981"
"Fremont",2009,"0","386","5","263","6","660"
"Fremont",2009,"1","345","1","266","0","612"
"Fremont",2009,"2","347","5","237","2","591"
"Fremont",2009,"3","380","7","235","1","623"
"Fremont",2009,"4","341","5","243","8","597"
"Fremont",2009,"5","339","3","182","3","527"
"Fremont",2009,"6","349","3","256","4","612"
"Fremont",2009,"7","354","5","137","3","499"
"Fremont",2009,"8","351","5","220","3","579"
"Fremont",2009,"9","354","10","132","1","497"
"Fremont",2009,"10","306","3","217","0","526"
"Fremont",2009,"11","327","3","170","3","503"
"Fremont",2009,"12","327","5","130","5","467"
"Fremont",2009,"13","355","1","202","3","561"
"Fremont",2009,"14","331","7","157","3","498"
"Fremont",2009,"15","380","0","186","2","568"
"Fremont",2009,"16","334","3","146","4","487"
"Fremont",2009,"17","407","1","211","1","620"
"Fremont",2009,"18 to 20","1092","6","500","7","1605"
"Fremont",2009,"21 to 24","1316","12","570","4","1902"
"Fremont",2009,"25 & over","21551","72","4417","111","26151"
"Fremont",2009,"Total","30272","162","9077","174","39685"
"Laramie",2010,"0","1183","61","25","18","1287"
"Laramie",2010,"1","1222","71","22","23","1338"
"Laramie",2010,"2","1281","75","23","21","1400"
"Laramie",2010,"3","1279","65","16","25","1385"
"Laramie",2010,"4","1224","66","29","21","1340"
"Laramie",2010,"5","1215","63","22","19","1319"
"Laramie",2010,"6","1203","55","22","23","1303"
"Laramie",2010,"7","1134","47","20","33","1234"
"Laramie",2010,"8","1110","44","21","24","1199"
"Laramie",2010,"9","1094","55","25","17","1191"
"Laramie",2010,"10","1140","49","20","18","1227"
"Laramie",2010,"11","1122","54","27","18","1221"
"Laramie",2010,"12","1079","58","33","20","1190"
"Laramie",2010,"13","1075","49","20","12","1156"
"Laramie",2010,"14","1045","44","18","22","1129"
"Laramie",2010,"15","1043","50","20","18","1131"
"Laramie",2010,"16","1104","47","20","20","1191"
"Laramie",2010,"17","1125","46","22","26","1219"
"Laramie",2010,"18 to 20","3374","224","55","72","3725"
"Laramie",2010,"21 to 24","4719","287","86","106","5198"
"Laramie",2010,"25 & over","57863","1396","736","894","60889"
"Laramie",2010,"Total","86634","2906","1282","1450","92272"
"Teton",2008,"0","282","2","3","2","289"
"Teton",2008,"1","273","2","3","1","279"
"Teton",2008,"2","302","3","3","3","311"
"Teton",2008,"3","242","1","3","3","249"
"Teton",2008,"4","164","3","3","2","172"
"Teton",2008,"5","220","1","1","3","225"
"Teton",2008,"6","209","3","4","4","220"
"Teton",2008,"7","191","2","2","6","201"
"Teton",2008,"8","181","2","2","3","188"
"Teton",2008,"9","175","0","2","3","180"
"Teton",2008,"10","215","2","3","3","223"
"Teton",2008,"11","183","1","2","1","187"
"Teton",2008,"12","214","2","2","4","222"
"Teton",2008,"13","209","1","1","3","214"
"Teton",2008,"14","211","1","1","5","218"
"Teton",2008,"15","204","1","2","6","213"
"Teton",2008,"16","211","0","2","2","215"
"Teton",2008,"17","219","2","4","2","227"
"Teton",2008,"18 to 20","439","4","6","8","457"
"Teton",2008,"21 to 24","1328","5","16","18","1367"
"Teton",2008,"25 & over","14804","44","118","165","15131"
"Teton",2008,"Total","20476","82","183","247","20988"
"Park",2001,"0","234","1","2","1","238"
"Park",2001,"1","275","1","1","2","279"
"Park",2001,"2","277","2","6","1","286"
"Park",2001,"3","291","1","1","1","294"
"Park",2001,"4","276","1","1","2","280"
"Park",2001,"5","294","0","1","0","295"
"Park",2001,"6","272","1","2","0","275"
"Park",2001,"7","291","2","1","1","295"
"Park",2001,"8","312","1","2","0","315"
"Park",2001,"9","344","2","2","1","349"
"Park",2001,"10","349","3","2","2","356"
"Park",2001,"11","336","0","3","2","341"
"Park",2001,"12","375","0","4","3","382"
"Park",2001,"13","385","4","2","2","393"
"Park",2001,"14","410","1","2","4","417"
"Park",2001,"15","407","2","1","2","412"
"Park",2001,"16","454","0","3","4","461"
"Park",2001,"17","387","0","2","3","392"
"Park",2001,"18 to 20","1284","1","13","12","1310"
"Park",2001,"21 to 24","1053","2","7","8","1070"
"Park",2001,"25 & over","17078","17","82","79","17256"
"Park",2001,"Total","25384","42","140","130","25696"
"Lincoln",1993,"0","195","0","3","0","198"
"Lincoln",1993,"1","213","0","2","3","218"
"Lincoln",1993,"2","223","0","1","0","224"
"Lincoln",1993,"3","225","0","0","0","225"
"Lincoln",1993,"4","216","0","0","0","216"
"Lincoln",1993,"5","224","1","0","0","225"
"Lincoln",1993,"6","245","0","0","1","246"
"Lincoln",1993,"7","272","0","0","0","272"
"Lincoln",1993,"8","287","0","3","0","290"
"Lincoln",1993,"9","306","0","2","0","308"
"Lincoln",1993,"10","293","1","5","3","302"
"Lincoln",1993,"11","341","0","1","0","342"
"Lincoln",1993,"12","305","0","2","0","307"
"Lincoln",1993,"13","323","0","5","0","328"
"Lincoln",1993,"14","296","0","1","0","297"
"Lincoln",1993,"15","294","1","3","0","298"
"Lincoln",1993,"16","289","0","1","0","290"
"Lincoln",1993,"17","261","0","0","0","261"
"Lincoln",1993,"18 to 20","448","1","5","0","454"
"Lincoln",1993,"21 to 24","411","0","0","0","411"
"Lincoln",1993,"25 & over","7571","1","24","21","7617"
"Lincoln",1993,"Total","13238","5","58","28","13329"
"Goshen",1995,"0","145","0","1","0","146"
"Goshen",1995,"1","141","2","5","0","148"
"Goshen",1995,"2","141","0","1","0","142"
"Goshen",1995,"3","154","0","1","0","155"
"Goshen",1995,"4","153","0","1","0","154"
"Goshen",1995,"5","149","2","3","0","154"
"Goshen",1995,"6","177","0","6","0","183"
"Goshen",1995,"7","141","0","1","0","142"
"Goshen",1995,"8","180","0","3","0","183"
"Goshen",1995,"9","200","0","2","0","202"
"Goshen",1995,"10","207","6","1","2","216"
"Goshen",1995,"11","186","0","7","0","193"
"Goshen",1995,"12","205","0","2","0","207"
"Goshen",1995,"13","211","0","0","0","211"
"Goshen",1995,"14","210","0","0","0","210"
"Goshen",1995,"15","224","0","5","0","229"
"Goshen",1995,"16","204","0","0","0","204"
"Goshen",1995,"17","195","0","2","0","197"
"Goshen",1995,"18 to 20","608","7","2","3","620"
"Goshen",1995,"21 to 24","521","0","0","2","523"
"Goshen",1995,"25 & over","8055","6","38","4","8103"
"Goshen",1995,"Total","12407","23","81","11","12522"
"Park",2008,"0","305","4","5","2","316"
"Park",2008,"1","319","3","3","0","325"
"Park",2008,"2","345","1","2","1","349"
"Park",2008,"3","285","2","2","2","291"
"Park",2008,"4","295","0","5","2","302"
"Park",2008,"5","334","1","2","1","338"
"Park",2008,"6","302","3","2","2","309"
"Park",2008,"7","272","2","4","2","280"
"Park",2008,"8","275","1","3","0","279"
"Park",2008,"9","270","3","2","2","277"
"Park",2008,"10","353","2","5","2","362"
"Park",2008,"11","301","2","5","2","310"
"Park",2008,"12","348","6","10","3","367"
"Park",2008,"13","303","6","4","5","318"
"Park",2008,"14","307","2","2","2","313"
"Park",2008,"15","369","1","3","3","376"
"Park",2008,"16","371","1","5","0","377"
"Park",2008,"17","380","5","2","1","388"
"Park",2008,"18 to 20","1238","16","17","25","1296"
"Park",2008,"21 to 24","1198","9","7","20","1234"
"Park",2008,"25 & over","18923","30","120","114","19187"
"Park",2008,"Total","27093","100","210","191","27594"
"Natrona",2008,"0","996","23","55","8","1082"
"Natrona",2008,"1","998","25","21","11","1055"
"Natrona",2008,"2","1040","30","13","5","1088"
"Natrona",2008,"3","992","32","9","12","1045"
"Natrona",2008,"4","964","35","20","13","1032"
"Natrona",2008,"5","967","36","18","11","1032"
"Natrona",2008,"6","920","21","31","17","989"
"Natrona",2008,"7","927","28","28","12","995"
"Natrona",2008,"8","816","17","12","4","849"
"Natrona",2008,"9","940","17","8","10","975"
"Natrona",2008,"10","884","29","17","10","940"
"Natrona",2008,"11","883","25","14","14","936"
"Natrona",2008,"12","871","19","15","5","910"
"Natrona",2008,"13","938","26","25","10","999"
"Natrona",2008,"14","944","18","16","11","989"
"Natrona",2008,"15","944","20","13","7","984"
"Natrona",2008,"16","975","15","18","5","1013"
"Natrona",2008,"17","997","10","30","12","1049"
"Natrona",2008,"18 to 20","2942","66","48","33","3089"
"Natrona",2008,"21 to 24","3991","74","92","45","4202"
"Natrona",2008,"25 & over","47006","476","584","363","48429"
"Natrona",2008,"Total","70935","1042","1087","618","73682"
"Natrona",2007,"0","1023","19","48","6","1096"
"Natrona",2007,"1","953","27","12","6","998"
"Natrona",2007,"2","999","23","14","7","1043"
"Natrona",2007,"3","986","46","13","8","1053"
"Natrona",2007,"4","940","28","19","11","998"
"Natrona",2007,"5","901","34","26","17","978"
"Natrona",2007,"6","923","25","34","15","997"
"Natrona",2007,"7","806","23","21","11","861"
"Natrona",2007,"8","880","15","15","3","913"
"Natrona",2007,"9","834","24","9","7","874"
"Natrona",2007,"10","914","26","16","6","962"
"Natrona",2007,"11","840","20","11","11","882"
"Natrona",2007,"12","951","18","15","7","991"
"Natrona",2007,"13","895","21","28","6","950"
"Natrona",2007,"14","952","23","17","14","1006"
"Natrona",2007,"15","944","18","12","7","981"
"Natrona",2007,"16","979","11","27","6","1023"
"Natrona",2007,"17","1121","7","22","5","1155"
"Natrona",2007,"18 to 20","2777","55","45","31","2908"
"Natrona",2007,"21 to 24","4003","69","97","45","4214"
"Natrona",2007,"25 & over","46113","486","538","345","47482"
"Natrona",2007,"Total","69734","1018","1039","574","72365"
"Sheridan",1992,"0","257","0","3","0","260"
"Sheridan",1992,"1","267","1","4","3","275"
"Sheridan",1992,"2","281","0","3","0","284"
"Sheridan",1992,"3","283","0","3","0","286"
"Sheridan",1992,"4","286","0","5","5","296"
"Sheridan",1992,"5","316","3","7","2","328"
"Sheridan",1992,"6","350","0","2","1","353"
"Sheridan",1992,"7","375","0","2","0","377"
"Sheridan",1992,"8","345","0","6","0","351"
"Sheridan",1992,"9","379","0","3","0","382"
"Sheridan",1992,"10","416","0","2","1","419"
"Sheridan",1992,"11","389","0","3","1","393"
"Sheridan",1992,"12","414","5","5","0","424"
"Sheridan",1992,"13","386","0","0","0","386"
"Sheridan",1992,"14","403","0","7","3","413"
"Sheridan",1992,"15","402","0","8","1","411"
"Sheridan",1992,"16","361","0","2","3","366"
"Sheridan",1992,"17","407","0","3","7","417"
"Sheridan",1992,"18 to 20","930","11","12","0","953"
"Sheridan",1992,"21 to 24","797","0","13","9","819"
"Sheridan",1992,"25 & over","15854","12","131","40","16037"
"Sheridan",1992,"Total","23898","32","224","76","24230"
"Hot Springs",2013,"0","47","0","1","0","48"
"Hot Springs",2013,"1","62","1","1","0","64"
"Hot Springs",2013,"2","61","1","1","0","63"
"Hot Springs",2013,"3","45","1","0","1","47"
"Hot Springs",2013,"4","50","1","0","0","51"
"Hot Springs",2013,"5","51","0","0","0","51"
"Hot Springs",2013,"6","70","2","1","0","73"
"Hot Springs",2013,"7","47","0","0","0","47"
"Hot Springs",2013,"8","59","0","2","0","61"
"Hot Springs",2013,"9","45","1","2","0","48"
"Hot Springs",2013,"10","53","0","0","2","55"
"Hot Springs",2013,"11","54","1","0","0","55"
"Hot Springs",2013,"12","47","0","1","1","49"
"Hot Springs",2013,"13","56","1","0","1","58"
"Hot Springs",2013,"14","59","1","0","0","60"
"Hot Springs",2013,"15","50","0","0","1","51"
"Hot Springs",2013,"16","54","1","1","1","57"
"Hot Springs",2013,"17","58","2","0","1","61"
"Hot Springs",2013,"18 to 20","117","8","3","2","130"
"Hot Springs",2013,"21 to 24","147","4","5","1","157"
"Hot Springs",2013,"25 & over","3452","35","46","21","3554"
"Hot Springs",2013,"Total","4684","60","64","32","4840"
"Uinta",1999,"0","308","0","2","0","310"
"Uinta",1999,"1","327","1","6","1","335"
"Uinta",1999,"2","327","0","1","0","328"
"Uinta",1999,"3","314","0","0","4","318"
"Uinta",1999,"4","352","2","2","3","359"
"Uinta",1999,"5","311","7","4","1","323"
"Uinta",1999,"6","353","2","2","3","360"
"Uinta",1999,"7","322","0","6","3","331"
"Uinta",1999,"8","335","0","1","0","336"
"Uinta",1999,"9","362","0","3","2","367"
"Uinta",1999,"10","398","4","5","7","414"
"Uinta",1999,"11","364","0","3","0","367"
"Uinta",1999,"12","420","0","5","0","425"
"Uinta",1999,"13","418","0","2","1","421"
"Uinta",1999,"14","438","0","6","0","444"
"Uinta",1999,"15","423","2","7","0","432"
"Uinta",1999,"16","484","0","9","4","497"
"Uinta",1999,"17","446","0","1","1","448"
"Uinta",1999,"18 to 20","883","0","8","5","896"
"Uinta",1999,"21 to 24","861","0","10","0","871"
"Uinta",1999,"25 & over","11197","6","77","39","11319"
"Uinta",1999,"Total","19643","24","160","74","19901"
"Hot Springs",2015,"0","43","2","1","0","46"
"Hot Springs",2015,"1","46","4","4","0","54"
"Hot Springs",2015,"2","44","1","2","0","47"
"Hot Springs",2015,"3","52","1","0","0","53"
"Hot Springs",2015,"4","47","1","0","0","48"
"Hot Springs",2015,"5","48","1","1","1","51"
"Hot Springs",2015,"6","49","1","0","0","50"
"Hot Springs",2015,"7","55","0","0","0","55"
"Hot Springs",2015,"8","67","2","2","0","71"
"Hot Springs",2015,"9","54","1","1","0","56"
"Hot Springs",2015,"10","55","0","0","0","55"
"Hot Springs",2015,"11","55","0","2","0","57"
"Hot Springs",2015,"12","65","0","0","1","66"
"Hot Springs",2015,"13","54","1","1","0","56"
"Hot Springs",2015,"14","49","0","1","1","51"
"Hot Springs",2015,"15","52","1","0","0","53"
"Hot Springs",2015,"16","58","0","1","0","59"
"Hot Springs",2015,"17","49","0","0","1","50"
"Hot Springs",2015,"18 to 20","117","2","3","3","125"
"Hot Springs",2015,"21 to 24","154","2","6","2","164"
"Hot Springs",2015,"25 & over","3385","24","48","21","3478"
"Hot Springs",2015,"Total","4598","44","73","30","4745"
"Sweetwater",2007,"0","662","20","32","2","716"
"Sweetwater",2007,"1","673","22","8","4","707"
"Sweetwater",2007,"2","578","14","15","5","612"
"Sweetwater",2007,"3","597","16","11","4","628"
"Sweetwater",2007,"4","700","14","10","6","730"
"Sweetwater",2007,"5","605","13","14","11","643"
"Sweetwater",2007,"6","566","10","13","5","594"
"Sweetwater",2007,"7","554","14","12","8","588"
"Sweetwater",2007,"8","569","9","3","9","590"
"Sweetwater",2007,"9","566","12","9","3","590"
"Sweetwater",2007,"10","569","8","16","3","596"
"Sweetwater",2007,"11","524","12","6","2","544"
"Sweetwater",2007,"12","514","8","7","3","532"
"Sweetwater",2007,"13","569","13","12","3","597"
"Sweetwater",2007,"14","552","10","12","8","582"
"Sweetwater",2007,"15","604","8","6","3","621"
"Sweetwater",2007,"16","599","9","7","9","624"
"Sweetwater",2007,"17","545","6","17","7","575"
"Sweetwater",2007,"18 to 20","1754","29","29","22","1834"
"Sweetwater",2007,"21 to 24","2571","40","36","38","2685"
"Sweetwater",2007,"25 & over","25076","276","298","232","25882"
"Sweetwater",2007,"Total","39947","563","573","387","41470"
"Campbell",2007,"0","709","4","42","5","760"
"Campbell",2007,"1","667","7","17","2","693"
"Campbell",2007,"2","664","6","7","3","680"
"Campbell",2007,"3","619","4","10","4","637"
"Campbell",2007,"4","621","3","9","4","637"
"Campbell",2007,"5","659","2","20","0","681"
"Campbell",2007,"6","640","7","25","5","677"
"Campbell",2007,"7","607","4","13","2","626"
"Campbell",2007,"8","605","7","6","0","618"
"Campbell",2007,"9","631","8","6","6","651"
"Campbell",2007,"10","576","5","16","6","603"
"Campbell",2007,"11","613","4","14","3","634"
"Campbell",2007,"12","606","5","5","3","619"
"Campbell",2007,"13","631","8","14","2","655"
"Campbell",2007,"14","611","7","11","7","636"
"Campbell",2007,"15","648","4","11","1","664"
"Campbell",2007,"16","645","5","12","3","665"
"Campbell",2007,"17","622","4","16","4","646"
"Campbell",2007,"18 to 20","1644","21","39","16","1720"
"Campbell",2007,"21 to 24","2496","14","50","21","2581"
"Campbell",2007,"25 & over","24981","98","308","181","25568"
"Campbell",2007,"Total","40495","227","651","278","41651"
"Platte",1992,"0","102","0","0","0","102"
"Platte",1992,"1","105","0","1","0","106"
"Platte",1992,"2","106","0","0","0","106"
"Platte",1992,"3","101","0","0","0","101"
"Platte",1992,"4","118","0","1","0","119"
"Platte",1992,"5","125","1","1","1","128"
"Platte",1992,"6","122","0","0","0","122"
"Platte",1992,"7","123","0","0","0","123"
"Platte",1992,"8","136","0","0","0","136"
"Platte",1992,"9","128","0","0","0","128"
"Platte",1992,"10","147","1","0","0","148"
"Platte",1992,"11","153","0","1","0","154"
"Platte",1992,"12","146","0","0","0","146"
"Platte",1992,"13","138","0","0","0","138"
"Platte",1992,"14","136","0","0","0","136"
"Platte",1992,"15","146","0","0","0","146"
"Platte",1992,"16","138","0","0","0","138"
"Platte",1992,"17","133","0","0","0","133"
"Platte",1992,"18 to 20","241","0","0","2","243"
"Platte",1992,"21 to 24","282","0","0","0","282"
"Platte",1992,"25 & over","5357","0","12","1","5370"
"Platte",1992,"Total","8183","2","16","4","8205"
"Uinta",1996,"0","326","0","2","0","328"
"Uinta",1996,"1","346","2","5","1","354"
"Uinta",1996,"2","328","0","1","0","329"
"Uinta",1996,"3","319","0","0","4","323"
"Uinta",1996,"4","361","2","2","3","368"
"Uinta",1996,"5","340","3","3","1","347"
"Uinta",1996,"6","398","2","2","3","405"
"Uinta",1996,"7","355","0","6","3","364"
"Uinta",1996,"8","359","2","1","0","362"
"Uinta",1996,"9","388","0","3","4","395"
"Uinta",1996,"10","436","2","4","5","447"
"Uinta",1996,"11","426","0","3","0","429"
"Uinta",1996,"12","456","0","6","0","462"
"Uinta",1996,"13","465","0","4","2","471"
"Uinta",1996,"14","470","0","5","0","475"
"Uinta",1996,"15","452","2","4","0","458"
"Uinta",1996,"16","492","0","6","3","501"
"Uinta",1996,"17","436","0","2","1","439"
"Uinta",1996,"18 to 20","815","0","4","5","824"
"Uinta",1996,"21 to 24","834","0","12","0","846"
"Uinta",1996,"25 & over","10908","5","68","28","11009"
"Uinta",1996,"Total","19710","20","143","63","19936"
"Natrona",2003,"0","859","23","15","5","902"
"Natrona",2003,"1","878","26","23","8","935"
"Natrona",2003,"2","841","34","20","7","902"
"Natrona",2003,"3","815","36","10","9","870"
"Natrona",2003,"4","860","19","11","8","898"
"Natrona",2003,"5","784","34","20","4","842"
"Natrona",2003,"6","877","16","17","7","917"
"Natrona",2003,"7","874","17","13","7","911"
"Natrona",2003,"8","902","12","10","0","924"
"Natrona",2003,"9","898","18","15","6","937"
"Natrona",2003,"10","908","18","15","6","947"
"Natrona",2003,"11","954","12","16","8","990"
"Natrona",2003,"12","932","14","15","6","967"
"Natrona",2003,"13","1050","15","22","5","1092"
"Natrona",2003,"14","928","11","17","6","962"
"Natrona",2003,"15","951","13","23","12","999"
"Natrona",2003,"16","983","12","14","3","1012"
"Natrona",2003,"17","1016","8","21","6","1051"
"Natrona",2003,"18 to 20","2928","49","54","27","3058"
"Natrona",2003,"21 to 24","3976","57","63","41","4137"
"Natrona",2003,"25 & over","42880","369","478","266","43993"
"Natrona",2003,"Total","66094","813","892","447","68246"
"Washakie",2010,"0","107","2","0","1","110"
"Washakie",2010,"1","104","4","1","1","110"
"Washakie",2010,"2","104","1","1","2","108"
"Washakie",2010,"3","121","1","2","1","125"
"Washakie",2010,"4","134","1","4","0","139"
"Washakie",2010,"5","122","2","2","1","127"
"Washakie",2010,"6","121","2","1","1","125"
"Washakie",2010,"7","124","1","3","1","129"
"Washakie",2010,"8","125","0","2","0","127"
"Washakie",2010,"9","113","2","1","0","116"
"Washakie",2010,"10","113","2","1","1","117"
"Washakie",2010,"11","115","1","3","1","120"
"Washakie",2010,"12","115","0","7","0","122"
"Washakie",2010,"13","114","0","3","2","119"
"Washakie",2010,"14","104","0","5","0","109"
"Washakie",2010,"15","115","1","4","3","123"
"Washakie",2010,"16","117","2","1","1","121"
"Washakie",2010,"17","121","2","5","2","130"
"Washakie",2010,"18 to 20","234","4","6","2","246"
"Washakie",2010,"21 to 24","257","3","1","10","271"
"Washakie",2010,"25 & over","5699","26","86","39","5850"
"Washakie",2010,"Total","8279","57","139","69","8544"
"Niobrara",2014,"0","24","0","0","0","24"
"Niobrara",2014,"1","28","1","0","0","29"
"Niobrara",2014,"2","23","0","1","0","24"
"Niobrara",2014,"3","23","0","0","0","23"
"Niobrara",2014,"4","23","0","0","0","23"
"Niobrara",2014,"5","23","0","1","0","24"
"Niobrara",2014,"6","18","0","0","0","18"
"Niobrara",2014,"7","18","0","0","0","18"
"Niobrara",2014,"8","18","0","2","0","20"
"Niobrara",2014,"9","18","0","0","0","18"
"Niobrara",2014,"10","19","0","0","0","19"
"Niobrara",2014,"11","32","0","0","0","32"
"Niobrara",2014,"12","19","2","0","0","21"
"Niobrara",2014,"13","32","0","0","0","32"
"Niobrara",2014,"14","19","1","0","0","20"
"Niobrara",2014,"15","40","0","0","0","40"
"Niobrara",2014,"16","27","1","0","0","28"
"Niobrara",2014,"17","33","1","0","0","34"
"Niobrara",2014,"18 to 20","67","1","0","1","69"
"Niobrara",2014,"21 to 24","100","2","1","1","104"
"Niobrara",2014,"25 & over","1817","20","27","7","1871"
"Niobrara",2014,"Total","2421","29","32","9","2491"
"Fremont",1991,"0","339","1","192","1","533"
"Fremont",1991,"1","335","6","181","0","522"
"Fremont",1991,"2","357","0","172","4","533"
"Fremont",1991,"3","374","0","168","0","542"
"Fremont",1991,"4","401","0","162","4","567"
"Fremont",1991,"5","418","1","176","4","599"
"Fremont",1991,"6","458","0","185","0","643"
"Fremont",1991,"7","440","0","169","2","611"
"Fremont",1991,"8","454","0","177","2","633"
"Fremont",1991,"9","515","0","179","2","696"
"Fremont",1991,"10","473","5","169","4","651"
"Fremont",1991,"11","477","0","199","2","678"
"Fremont",1991,"12","479","0","153","0","632"
"Fremont",1991,"13","481","5","150","0","636"
"Fremont",1991,"14","456","0","124","0","580"
"Fremont",1991,"15","426","0","111","4","541"
"Fremont",1991,"16","439","2","119","1","561"
"Fremont",1991,"17","410","0","125","0","535"
"Fremont",1991,"18 to 20","887","3","340","3","1233"
"Fremont",1991,"21 to 24","953","3","408","9","1373"
"Fremont",1991,"25 & over","17805","19","2878","48","20750"
"Fremont",1991,"Total","27377","45","6537","90","34049"
"Uinta",2005,"0","269","4","11","1","285"
"Uinta",2005,"1","313","1","2","2","318"
"Uinta",2005,"2","328","2","2","1","333"
"Uinta",2005,"3","312","1","1","1","315"
"Uinta",2005,"4","280","6","3","2","291"
"Uinta",2005,"5","330","2","2","2","336"
"Uinta",2005,"6","321","3","3","1","328"
"Uinta",2005,"7","288","2","5","2","297"
"Uinta",2005,"8","325","2","2","2","331"
"Uinta",2005,"9","307","4","2","2","315"
"Uinta",2005,"10","315","4","2","1","322"
"Uinta",2005,"11","313","2","5","4","324"
"Uinta",2005,"12","324","2","7","1","334"
"Uinta",2005,"13","305","1","4","0","310"
"Uinta",2005,"14","323","1","6","3","333"
"Uinta",2005,"15","357","4","8","0","369"
"Uinta",2005,"16","370","2","5","4","381"
"Uinta",2005,"17","376","2","5","2","385"
"Uinta",2005,"18 to 20","770","6","19","3","798"
"Uinta",2005,"21 to 24","947","0","8","4","959"
"Uinta",2005,"25 & over","11624","34","124","48","11830"
"Uinta",2005,"Total","19097","85","226","86","19494"
"Platte",2007,"0","101","2","0","1","104"
"Platte",2007,"1","102","0","2","0","104"
"Platte",2007,"2","76","2","1","0","79"
"Platte",2007,"3","75","1","1","1","78"
"Platte",2007,"4","72","2","0","1","75"
"Platte",2007,"5","94","1","0","0","95"
"Platte",2007,"6","101","2","0","0","103"
"Platte",2007,"7","90","2","0","0","92"
"Platte",2007,"8","111","2","0","0","113"
"Platte",2007,"9","86","0","0","0","86"
"Platte",2007,"10","105","0","1","2","108"
"Platte",2007,"11","93","1","0","0","94"
"Platte",2007,"12","122","1","1","0","124"
"Platte",2007,"13","115","1","0","1","117"
"Platte",2007,"14","115","0","1","3","119"
"Platte",2007,"15","144","2","1","0","147"
"Platte",2007,"16","134","0","1","2","137"
"Platte",2007,"17","154","0","3","1","158"
"Platte",2007,"18 to 20","229","1","2","3","235"
"Platte",2007,"21 to 24","298","1","3","2","304"
"Platte",2007,"25 & over","6138","19","32","21","6210"
"Platte",2007,"Total","8555","40","49","38","8682"
"Crook",1995,"0","71","0","0","0","71"
"Crook",1995,"1","68","0","2","0","70"
"Crook",1995,"2","71","0","0","0","71"
"Crook",1995,"3","65","0","0","0","65"
"Crook",1995,"4","76","0","0","0","76"
"Crook",1995,"5","77","0","2","0","79"
"Crook",1995,"6","87","0","0","0","87"
"Crook",1995,"7","90","0","0","0","90"
"Crook",1995,"8","89","0","0","0","89"
"Crook",1995,"9","93","0","0","0","93"
"Crook",1995,"10","106","0","3","0","109"
"Crook",1995,"11","110","0","0","0","110"
"Crook",1995,"12","114","0","0","0","114"
"Crook",1995,"13","120","0","0","0","120"
"Crook",1995,"14","109","0","0","0","109"
"Crook",1995,"15","112","0","4","0","116"
"Crook",1995,"16","108","0","0","0","108"
"Crook",1995,"17","103","0","0","0","103"
"Crook",1995,"18 to 20","193","0","2","0","195"
"Crook",1995,"21 to 24","183","0","0","0","183"
"Crook",1995,"25 & over","3609","0","15","0","3624"
"Crook",1995,"Total","5654","0","28","0","5682"
"Goshen",2007,"0","138","2","2","0","142"
"Goshen",2007,"1","112","2","1","1","116"
"Goshen",2007,"2","117","5","0","2","124"
"Goshen",2007,"3","174","3","3","0","180"
"Goshen",2007,"4","130","1","2","0","133"
"Goshen",2007,"5","121","1","1","0","123"
"Goshen",2007,"6","134","1","2","3","140"
"Goshen",2007,"7","130","1","3","1","135"
"Goshen",2007,"8","111","2","1","0","114"
"Goshen",2007,"9","144","1","2","1","148"
"Goshen",2007,"10","132","2","1","1","136"
"Goshen",2007,"11","131","0","1","1","133"
"Goshen",2007,"12","141","1","5","1","148"
"Goshen",2007,"13","188","2","2","1","193"
"Goshen",2007,"14","137","2","3","2","144"
"Goshen",2007,"15","155","3","2","0","160"
"Goshen",2007,"16","188","3","2","0","193"
"Goshen",2007,"17","199","2","3","0","204"
"Goshen",2007,"18 to 20","606","12","9","5","632"
"Goshen",2007,"21 to 24","535","10","7","2","554"
"Goshen",2007,"25 & over","8637","37","68","26","8768"
"Goshen",2007,"Total","12360","93","120","47","12620"
"Weston",2016,"0","63","2","0","0","65"
"Weston",2016,"1","73","1","1","0","75"
"Weston",2016,"2","92","1","3","0","96"
"Weston",2016,"3","91","1","5","0","97"
"Weston",2016,"4","98","2","2","0","102"
"Weston",2016,"5","81","2","0","1","84"
"Weston",2016,"6","88","1","2","1","92"
"Weston",2016,"7","74","1","2","0","77"
"Weston",2016,"8","76","0","0","0","76"
"Weston",2016,"9","76","3","1","0","80"
"Weston",2016,"10","89","2","3","0","94"
"Weston",2016,"11","100","0","2","0","102"
"Weston",2016,"12","100","2","2","0","104"
"Weston",2016,"13","86","2","3","2","93"
"Weston",2016,"14","77","2","3","1","83"
"Weston",2016,"15","84","0","1","0","85"
"Weston",2016,"16","69","1","0","1","71"
"Weston",2016,"17","75","0","1","0","76"
"Weston",2016,"18 to 20","200","7","5","1","213"
"Weston",2016,"21 to 24","295","12","9","1","317"
"Weston",2016,"25 & over","5000","42","76","36","5154"
"Weston",2016,"Total","6987","84","121","44","7236"
"Laramie",2012,"0","1114","76","27","19","1236"
"Laramie",2012,"1","1157","72","16","16","1261"
"Laramie",2012,"2","1179","60","23","19","1281"
"Laramie",2012,"3","1187","64","16","26","1293"
"Laramie",2012,"4","1274","69","24","27","1394"
"Laramie",2012,"5","1267","61","19","17","1364"
"Laramie",2012,"6","1199","59","28","21","1307"
"Laramie",2012,"7","1180","48","26","27","1281"
"Laramie",2012,"8","1200","42","22","32","1296"
"Laramie",2012,"9","1145","52","26","22","1245"
"Laramie",2012,"10","1121","34","22","19","1196"
"Laramie",2012,"11","1092","52","23","21","1188"
"Laramie",2012,"12","1127","41","20","12","1200"
"Laramie",2012,"13","1113","54","30","14","1211"
"Laramie",2012,"14","1069","48","26","19","1162"
"Laramie",2012,"15","1081","46","14","11","1152"
"Laramie",2012,"16","1059","49","18","24","1150"
"Laramie",2012,"17","1056","66","15","23","1160"
"Laramie",2012,"18 to 20","3328","269","60","71","3728"
"Laramie",2012,"21 to 24","5105","366","90","136","5697"
"Laramie",2012,"25 & over","59413","1866","751","953","62983"
"Laramie",2012,"Total","88466","3494","1296","1529","94785"
"Lincoln",1994,"0","197","0","2","0","199"
"Lincoln",1994,"1","212","0","2","1","215"
"Lincoln",1994,"2","219","0","1","0","220"
"Lincoln",1994,"3","216","0","0","0","216"
"Lincoln",1994,"4","223","0","0","0","223"
"Lincoln",1994,"5","227","3","0","0","230"
"Lincoln",1994,"6","244","0","0","2","246"
"Lincoln",1994,"7","263","0","0","0","263"
"Lincoln",1994,"8","282","0","4","0","286"
"Lincoln",1994,"9","315","0","2","0","317"
"Lincoln",1994,"10","278","1","7","3","289"
"Lincoln",1994,"11","339","0","0","0","339"
"Lincoln",1994,"12","312","0","1","0","313"
"Lincoln",1994,"13","329","0","4","0","333"
"Lincoln",1994,"14","314","0","0","0","314"
"Lincoln",1994,"15","312","3","4","0","319"
"Lincoln",1994,"16","301","0","1","0","302"
"Lincoln",1994,"17","290","0","0","0","290"
"Lincoln",1994,"18 to 20","471","1","6","0","478"
"Lincoln",1994,"21 to 24","436","0","0","0","436"
"Lincoln",1994,"25 & over","7885","1","22","23","7931"
"Lincoln",1994,"Total","13665","9","56","29","13759"
"Platte",2009,"0","83","2","0","1","86"
"Platte",2009,"1","83","0","2","0","85"
"Platte",2009,"2","91","2","2","0","95"
"Platte",2009,"3","89","1","1","1","92"
"Platte",2009,"4","72","2","0","2","76"
"Platte",2009,"5","87","1","0","0","88"
"Platte",2009,"6","92","2","0","0","94"
"Platte",2009,"7","106","2","0","0","108"
"Platte",2009,"8","87","2","1","0","90"
"Platte",2009,"9","81","0","0","0","81"
"Platte",2009,"10","114","0","1","2","117"
"Platte",2009,"11","86","0","0","0","86"
"Platte",2009,"12","111","1","1","0","113"
"Platte",2009,"13","100","1","0","1","102"
"Platte",2009,"14","106","0","1","3","110"
"Platte",2009,"15","116","2","1","0","119"
"Platte",2009,"16","126","0","1","2","129"
"Platte",2009,"17","131","0","3","2","136"
"Platte",2009,"18 to 20","233","1","2","4","240"
"Platte",2009,"21 to 24","280","1","2","2","285"
"Platte",2009,"25 & over","6195","26","33","22","6276"
"Platte",2009,"Total","8469","46","51","42","8608"
"Lincoln",2009,"0","289","0","0","1","290"
"Lincoln",2009,"1","301","2","2","0","305"
"Lincoln",2009,"2","302","1","3","0","306"
"Lincoln",2009,"3","296","0","2","0","298"
"Lincoln",2009,"4","275","1","2","0","278"
"Lincoln",2009,"5","252","1","4","3","260"
"Lincoln",2009,"6","290","1","4","0","295"
"Lincoln",2009,"7","275","0","6","0","281"
"Lincoln",2009,"8","242","2","3","0","247"
"Lincoln",2009,"9","290","3","3","0","296"
"Lincoln",2009,"10","306","1","5","1","313"
"Lincoln",2009,"11","274","3","9","1","287"
"Lincoln",2009,"12","294","1","1","2","298"
"Lincoln",2009,"13","247","3","5","1","256"
"Lincoln",2009,"14","277","2","3","0","282"
"Lincoln",2009,"15","268","3","5","1","277"
"Lincoln",2009,"16","284","3","3","2","292"
"Lincoln",2009,"17","269","0","5","0","274"
"Lincoln",2009,"18 to 20","510","2","3","1","516"
"Lincoln",2009,"21 to 24","647","3","10","1","661"
"Lincoln",2009,"25 & over","11607","18","99","46","11770"
"Lincoln",2009,"Total","17795","50","177","60","18082"
"Albany",2016,"0","390","14","7","19","430"
"Albany",2016,"1","368","13","8","17","406"
"Albany",2016,"2","347","16","5","7","375"
"Albany",2016,"3","322","17","6","13","358"
"Albany",2016,"4","347","15","9","17","388"
"Albany",2016,"5","326","15","6","17","364"
"Albany",2016,"6","332","12","5","7","356"
"Albany",2016,"7","342","16","6","9","373"
"Albany",2016,"8","323","13","6","9","351"
"Albany",2016,"9","352","9","5","13","379"
"Albany",2016,"10","331","6","6","11","354"
"Albany",2016,"11","318","6","9","5","338"
"Albany",2016,"12","285","12","4","7","308"
"Albany",2016,"13","284","5","3","7","299"
"Albany",2016,"14","284","6","7","11","308"
"Albany",2016,"15","310","5","9","11","335"
"Albany",2016,"16","282","8","8","7","305"
"Albany",2016,"17","268","21","7","13","309"
"Albany",2016,"18 to 20","3710","77","22","205","4014"
"Albany",2016,"21 to 24","6330","172","101","230","6833"
"Albany",2016,"25 & over","19671","397","278","727","21073"
"Albany",2016,"Total","35522","855","517","1362","38256"
"Niobrara",2009,"0","19","1","0","0","20"
"Niobrara",2009,"1","26","0","0","0","26"
"Niobrara",2009,"2","16","0","0","0","16"
"Niobrara",2009,"3","20","0","0","0","20"
"Niobrara",2009,"4","14","0","1","0","15"
"Niobrara",2009,"5","20","0","0","0","20"
"Niobrara",2009,"6","28","0","0","0","28"
"Niobrara",2009,"7","27","0","0","0","27"
"Niobrara",2009,"8","25","0","0","0","25"
"Niobrara",2009,"9","32","0","0","0","32"
"Niobrara",2009,"10","29","1","0","0","30"
"Niobrara",2009,"11","38","0","0","0","38"
"Niobrara",2009,"12","31","2","0","0","33"
"Niobrara",2009,"13","26","0","0","0","26"
"Niobrara",2009,"14","29","0","0","1","30"
"Niobrara",2009,"15","25","0","0","0","25"
"Niobrara",2009,"16","28","0","0","0","28"
"Niobrara",2009,"17","37","0","0","1","38"
"Niobrara",2009,"18 to 20","53","0","0","0","53"
"Niobrara",2009,"21 to 24","98","1","3","0","102"
"Niobrara",2009,"25 & over","1809","8","19","7","1843"
"Niobrara",2009,"Total","2430","13","23","9","2475"
"Natrona",2013,"0","1064","36","36","9","1145"
"Natrona",2013,"1","1002","35","25","14","1076"
"Natrona",2013,"2","993","43","31","19","1086"
"Natrona",2013,"3","1070","32","23","8","1133"
"Natrona",2013,"4","1022","30","16","16","1084"
"Natrona",2013,"5","1099","36","24","19","1178"
"Natrona",2013,"6","1118","27","19","20","1184"
"Natrona",2013,"7","1078","35","25","5","1143"
"Natrona",2013,"8","1004","24","17","11","1056"
"Natrona",2013,"9","1035","25","28","15","1103"
"Natrona",2013,"10","985","24","22","11","1042"
"Natrona",2013,"11","958","14","21","9","1002"
"Natrona",2013,"12","981","28","23","11","1043"
"Natrona",2013,"13","936","21","18","8","983"
"Natrona",2013,"14","945","31","20","16","1012"
"Natrona",2013,"15","913","33","17","7","970"
"Natrona",2013,"16","904","22","26","9","961"
"Natrona",2013,"17","985","42","20","13","1060"
"Natrona",2013,"18 to 20","2755","128","58","38","2979"
"Natrona",2013,"21 to 24","4637","150","105","52","4944"
"Natrona",2013,"25 & over","51617","1022","714","555","53908"
"Natrona",2013,"Total","77101","1838","1288","865","81092"
"Converse",2000,"0","156","0","0","1","157"
"Converse",2000,"1","130","2","3","0","135"
"Converse",2000,"2","136","1","0","0","137"
"Converse",2000,"3","165","0","3","0","168"
"Converse",2000,"4","172","1","5","0","178"
"Converse",2000,"5","174","2","2","0","178"
"Converse",2000,"6","148","0","1","0","149"
"Converse",2000,"7","183","2","4","1","190"
"Converse",2000,"8","190","1","1","0","192"
"Converse",2000,"9","196","2","4","1","203"
"Converse",2000,"10","184","3","4","2","193"
"Converse",2000,"11","184","1","3","0","188"
"Converse",2000,"12","196","2","2","0","200"
"Converse",2000,"13","227","0","1","2","230"
"Converse",2000,"14","222","4","4","1","231"
"Converse",2000,"15","227","0","0","1","228"
"Converse",2000,"16","225","0","2","0","227"
"Converse",2000,"17","255","1","3","2","261"
"Converse",2000,"18 to 20","403","1","7","3","414"
"Converse",2000,"21 to 24","437","0","5","1","443"
"Converse",2000,"25 & over","7676","7","77","21","7781"
"Converse",2000,"Total","11886","30","131","36","12083"
"Carbon",2010,"0","216","4","3","3","226"
"Carbon",2010,"1","229","3","1","0","233"
"Carbon",2010,"2","222","1","1","2","226"
"Carbon",2010,"3","226","2","2","3","233"
"Carbon",2010,"4","203","5","1","4","213"
"Carbon",2010,"5","215","5","4","3","227"
"Carbon",2010,"6","215","3","0","1","219"
"Carbon",2010,"7","189","3","1","0","193"
"Carbon",2010,"8","186","3","7","2","198"
"Carbon",2010,"9","195","5","6","2","208"
"Carbon",2010,"10","194","6","4","1","205"
"Carbon",2010,"11","201","0","6","1","208"
"Carbon",2010,"12","189","2","3","1","195"
"Carbon",2010,"13","186","2","2","2","192"
"Carbon",2010,"14","179","2","4","2","187"
"Carbon",2010,"15","182","0","6","1","189"
"Carbon",2010,"16","187","1","5","1","194"
"Carbon",2010,"17","183","0","2","0","185"
"Carbon",2010,"18 to 20","438","8","8","3","457"
"Carbon",2010,"21 to 24","723","10","19","10","762"
"Carbon",2010,"25 & over","10531","100","155","101","10887"
"Carbon",2010,"Total","15289","165","240","143","15837"
"Fremont",1997,"0","314","0","128","1","443"
"Fremont",1997,"1","312","8","154","0","474"
"Fremont",1997,"2","325","0","131","2","458"
"Fremont",1997,"3","318","0","150","0","468"
"Fremont",1997,"4","321","0","176","3","500"
"Fremont",1997,"5","340","2","199","1","542"
"Fremont",1997,"6","376","0","194","0","570"
"Fremont",1997,"7","372","0","170","1","543"
"Fremont",1997,"8","384","0","162","2","548"
"Fremont",1997,"9","412","0","161","2","575"
"Fremont",1997,"10","386","4","136","6","532"
"Fremont",1997,"11","435","0","183","3","621"
"Fremont",1997,"12","457","0","182","0","639"
"Fremont",1997,"13","494","3","185","0","682"
"Fremont",1997,"14","541","0","183","0","724"
"Fremont",1997,"15","498","0","153","1","652"
"Fremont",1997,"16","502","3","159","1","665"
"Fremont",1997,"17","505","0","160","0","665"
"Fremont",1997,"18 to 20","1083","4","383","4","1474"
"Fremont",1997,"21 to 24","1000","5","368","11","1384"
"Fremont",1997,"25 & over","19153","19","3304","63","22539"
"Fremont",1997,"Total","28528","48","7021","101","35698"
"Sheridan",2009,"0","368","3","3","1","375"
"Sheridan",2009,"1","333","1","7","2","343"
"Sheridan",2009,"2","407","2","7","2","418"
"Sheridan",2009,"3","311","3","7","3","324"
"Sheridan",2009,"4","354","1","6","4","365"
"Sheridan",2009,"5","313","2","4","3","322"
"Sheridan",2009,"6","373","3","8","0","384"
"Sheridan",2009,"7","314","3","6","2","325"
"Sheridan",2009,"8","335","0","9","2","346"
"Sheridan",2009,"9","335","4","7","1","347"
"Sheridan",2009,"10","330","3","9","1","343"
"Sheridan",2009,"11","317","5","7","2","331"
"Sheridan",2009,"12","336","2","10","1","349"
"Sheridan",2009,"13","325","3","4","1","333"
"Sheridan",2009,"14","296","1","10","5","312"
"Sheridan",2009,"15","377","5","19","4","405"
"Sheridan",2009,"16","391","5","17","2","415"
"Sheridan",2009,"17","364","4","19","1","388"
"Sheridan",2009,"18 to 20","1099","15","28","21","1163"
"Sheridan",2009,"21 to 24","1176","16","18","18","1228"
"Sheridan",2009,"25 & over","19749","73","233","146","20201"
"Sheridan",2009,"Total","28203","154","438","222","29017"
"Platte",1993,"0","101","0","0","0","101"
"Platte",1993,"1","101","0","1","0","102"
"Platte",1993,"2","98","0","0","0","98"
"Platte",1993,"3","104","0","0","0","104"
"Platte",1993,"4","113","0","1","0","114"
"Platte",1993,"5","121","1","1","1","124"
"Platte",1993,"6","114","0","0","0","114"
"Platte",1993,"7","120","0","0","0","120"
"Platte",1993,"8","139","0","0","0","139"
"Platte",1993,"9","123","0","0","0","123"
"Platte",1993,"10","144","0","0","0","144"
"Platte",1993,"11","153","0","1","0","154"
"Platte",1993,"12","149","0","0","0","149"
"Platte",1993,"13","149","0","0","0","149"
"Platte",1993,"14","140","0","0","0","140"
"Platte",1993,"15","152","0","0","0","152"
"Platte",1993,"16","143","0","0","0","143"
"Platte",1993,"17","133","0","0","0","133"
"Platte",1993,"18 to 20","246","0","0","2","248"
"Platte",1993,"21 to 24","287","0","0","0","287"
"Platte",1993,"25 & over","5398","0","8","1","5407"
"Platte",1993,"Total","8228","1","12","4","8245"
"Teton",1995,"0","183","0","2","2","187"
"Teton",1995,"1","179","2","0","2","183"
"Teton",1995,"2","178","0","2","0","180"
"Teton",1995,"3","181","0","0","1","182"
"Teton",1995,"4","168","0","3","0","171"
"Teton",1995,"5","175","0","2","0","177"
"Teton",1995,"6","160","0","0","0","160"
"Teton",1995,"7","165","4","1","0","170"
"Teton",1995,"8","177","0","0","2","179"
"Teton",1995,"9","185","1","0","0","186"
"Teton",1995,"10","203","1","2","0","206"
"Teton",1995,"11","188","0","0","0","188"
"Teton",1995,"12","189","0","0","0","189"
"Teton",1995,"13","206","0","0","0","206"
"Teton",1995,"14","191","0","2","2","195"
"Teton",1995,"15","174","2","2","1","179"
"Teton",1995,"16","185","0","2","0","187"
"Teton",1995,"17","170","0","0","0","170"
"Teton",1995,"18 to 20","407","1","5","0","413"
"Teton",1995,"21 to 24","907","2","5","7","921"
"Teton",1995,"25 & over","10180","7","55","36","10278"
"Teton",1995,"Total","14751","20","83","53","14907"
"Converse",2014,"0","195","6","6","0","207"
"Converse",2014,"1","178","4","6","1","189"
"Converse",2014,"2","217","6","6","0","229"
"Converse",2014,"3","164","3","1","0","168"
"Converse",2014,"4","197","5","4","1","207"
"Converse",2014,"5","208","6","2","1","217"
"Converse",2014,"6","178","2","2","0","182"
"Converse",2014,"7","195","4","2","2","203"
"Converse",2014,"8","199","6","7","1","213"
"Converse",2014,"9","215","3","3","1","222"
"Converse",2014,"10","171","5","5","0","181"
"Converse",2014,"11","173","3","3","1","180"
"Converse",2014,"12","190","4","7","1","202"
"Converse",2014,"13","182","2","0","2","186"
"Converse",2014,"14","194","1","0","5","200"
"Converse",2014,"15","196","5","4","1","206"
"Converse",2014,"16","187","2","3","0","192"
"Converse",2014,"17","175","1","3","0","179"
"Converse",2014,"18 to 20","441","10","6","3","460"
"Converse",2014,"21 to 24","666","13","6","8","693"
"Converse",2014,"25 & over","9232","91","115","56","9494"
"Converse",2014,"Total","13753","182","191","84","14210"
"Park",2002,"0","262","1","3","1","267"
"Park",2002,"1","247","1","1","2","251"
"Park",2002,"2","267","2","4","1","274"
"Park",2002,"3","268","1","2","1","272"
"Park",2002,"4","297","1","1","3","302"
"Park",2002,"5","280","0","1","0","281"
"Park",2002,"6","303","1","2","0","306"
"Park",2002,"7","278","2","1","1","282"
"Park",2002,"8","296","1","3","0","300"
"Park",2002,"9","323","2","1","1","327"
"Park",2002,"10","351","2","3","3","359"
"Park",2002,"11","355","0","3","2","360"
"Park",2002,"12","338","2","6","3","349"
"Park",2002,"13","373","6","2","2","383"
"Park",2002,"14","383","2","3","5","393"
"Park",2002,"15","415","1","1","3","420"
"Park",2002,"16","403","0","3","3","409"
"Park",2002,"17","419","0","2","2","423"
"Park",2002,"18 to 20","1251","2","13","14","1280"
"Park",2002,"21 to 24","1113","4","8","7","1132"
"Park",2002,"25 & over","17206","18","83","84","17391"
"Park",2002,"Total","25428","49","146","138","25761"
"Platte",1996,"0","101","0","0","0","101"
"Platte",1996,"1","100","0","1","0","101"
"Platte",1996,"2","89","0","0","0","89"
"Platte",1996,"3","95","0","0","0","95"
"Platte",1996,"4","98","0","1","0","99"
"Platte",1996,"5","122","1","1","1","125"
"Platte",1996,"6","110","0","0","0","110"
"Platte",1996,"7","119","0","0","0","119"
"Platte",1996,"8","127","0","0","0","127"
"Platte",1996,"9","120","0","0","0","120"
"Platte",1996,"10","145","2","0","0","147"
"Platte",1996,"11","147","0","1","0","148"
"Platte",1996,"12","152","0","0","0","152"
"Platte",1996,"13","155","0","0","0","155"
"Platte",1996,"14","147","0","0","0","147"
"Platte",1996,"15","164","0","0","0","164"
"Platte",1996,"16","161","0","0","0","161"
"Platte",1996,"17","153","0","0","0","153"
"Platte",1996,"18 to 20","269","0","0","1","270"
"Platte",1996,"21 to 24","295","0","0","0","295"
"Platte",1996,"25 & over","5697","0","10","1","5708"
"Platte",1996,"Total","8566","3","14","3","8586"
"Lincoln",2003,"0","224","0","2","0","226"
"Lincoln",2003,"1","205","0","1","2","208"
"Lincoln",2003,"2","163","1","4","1","169"
"Lincoln",2003,"3","229","0","0","1","230"
"Lincoln",2003,"4","200","0","2","1","203"
"Lincoln",2003,"5","220","1","3","0","224"
"Lincoln",2003,"6","204","0","2","1","207"
"Lincoln",2003,"7","214","0","1","0","215"
"Lincoln",2003,"8","201","2","2","0","205"
"Lincoln",2003,"9","255","2","1","0","258"
"Lincoln",2003,"10","253","2","2","0","257"
"Lincoln",2003,"11","241","3","4","0","248"
"Lincoln",2003,"12","287","4","1","2","294"
"Lincoln",2003,"13","234","1","3","0","238"
"Lincoln",2003,"14","288","1","0","2","291"
"Lincoln",2003,"15","269","2","1","0","272"
"Lincoln",2003,"16","299","1","1","2","303"
"Lincoln",2003,"17","283","3","3","0","289"
"Lincoln",2003,"18 to 20","595","2","4","3","604"
"Lincoln",2003,"21 to 24","596","2","4","0","602"
"Lincoln",2003,"25 & over","9474","10","57","33","9574"
"Lincoln",2003,"Total","14934","37","98","48","15117"
"Park",1992,"0","290","0","1","1","292"
"Park",1992,"1","315","0","7","0","322"
"Park",1992,"2","325","0","1","3","329"
"Park",1992,"3","326","0","0","0","326"
"Park",1992,"4","328","0","2","1","331"
"Park",1992,"5","337","1","2","7","347"
"Park",1992,"6","352","0","0","0","352"
"Park",1992,"7","374","0","3","0","377"
"Park",1992,"8","370","0","2","0","372"
"Park",1992,"9","391","0","2","0","393"
"Park",1992,"10","389","0","7","0","396"
"Park",1992,"11","406","0","0","5","411"
"Park",1992,"12","423","0","4","2","429"
"Park",1992,"13","380","1","3","1","385"
"Park",1992,"14","374","1","0","1","376"
"Park",1992,"15","371","2","3","0","376"
"Park",1992,"16","351","0","3","2","356"
"Park",1992,"17","363","0","1","0","364"
"Park",1992,"18 to 20","1212","0","13","14","1239"
"Park",1992,"21 to 24","919","0","2","15","936"
"Park",1992,"25 & over","14914","8","58","52","15032"
"Park",1992,"Total","23510","13","114","104","23741"
"Sheridan",1999,"0","285","0","5","0","290"
"Sheridan",1999,"1","243","1","5","4","253"
"Sheridan",1999,"2","291","0","2","0","293"
"Sheridan",1999,"3","295","0","3","0","298"
"Sheridan",1999,"4","251","0","9","1","261"
"Sheridan",1999,"5","282","2","9","4","297"
"Sheridan",1999,"6","317","0","8","10","335"
"Sheridan",1999,"7","355","0","2","0","357"
"Sheridan",1999,"8","312","0","12","0","324"
"Sheridan",1999,"9","338","0","5","0","343"
"Sheridan",1999,"10","352","0","6","1","359"
"Sheridan",1999,"11","354","0","3","1","358"
"Sheridan",1999,"12","383","6","8","0","397"
"Sheridan",1999,"13","381","3","4","0","388"
"Sheridan",1999,"14","421","0","21","11","453"
"Sheridan",1999,"15","477","1","19","1","498"
"Sheridan",1999,"16","471","0","9","6","486"
"Sheridan",1999,"17","469","0","6","7","482"
"Sheridan",1999,"18 to 20","1054","14","18","0","1086"
"Sheridan",1999,"21 to 24","984","0","19","8","1011"
"Sheridan",1999,"25 & over","17495","10","187","67","17759"
"Sheridan",1999,"Total","25810","37","360","121","26328"
"Natrona",1999,"0","781","13","12","3","809"
"Natrona",1999,"1","860","19","6","10","895"
"Natrona",1999,"2","812","6","15","2","835"
"Natrona",1999,"3","853","27","20","8","908"
"Natrona",1999,"4","847","14","10","6","877"
"Natrona",1999,"5","874","16","11","6","907"
"Natrona",1999,"6","897","14","15","0","926"
"Natrona",1999,"7","884","14","12","7","917"
"Natrona",1999,"8","936","3","19","2","960"
"Natrona",1999,"9","947","24","19","5","995"
"Natrona",1999,"10","1012","21","16","6","1055"
"Natrona",1999,"11","941","16","12","4","973"
"Natrona",1999,"12","985","18","19","6","1028"
"Natrona",1999,"13","1020","17","12","7","1056"
"Natrona",1999,"14","1026","7","27","5","1065"
"Natrona",1999,"15","1093","20","22","8","1143"
"Natrona",1999,"16","1049","11","8","7","1075"
"Natrona",1999,"17","1086","9","11","5","1111"
"Natrona",1999,"18 to 20","3200","44","42","24","3310"
"Natrona",1999,"21 to 24","3247","36","47","23","3353"
"Natrona",1999,"25 & over","41201","280","420","183","42084"
"Natrona",1999,"Total","64551","629","775","327","66282"
"Natrona",2006,"0","941","17","19","5","982"
"Natrona",2006,"1","898","25","9","12","944"
"Natrona",2006,"2","1002","39","14","7","1062"
"Natrona",2006,"3","892","32","9","9","942"
"Natrona",2006,"4","909","26","27","15","977"
"Natrona",2006,"5","870","41","27","9","947"
"Natrona",2006,"6","814","20","20","13","867"
"Natrona",2006,"7","876","15","15","10","916"
"Natrona",2006,"8","817","23","15","2","857"
"Natrona",2006,"9","863","25","12","6","906"
"Natrona",2006,"10","888","19","15","8","930"
"Natrona",2006,"11","947","19","11","14","991"
"Natrona",2006,"12","894","19","11","6","930"
"Natrona",2006,"13","914","20","25","5","964"
"Natrona",2006,"14","963","18","15","7","1003"
"Natrona",2006,"15","953","14","19","10","996"
"Natrona",2006,"16","1125","9","27","4","1165"
"Natrona",2006,"17","954","8","15","4","981"
"Natrona",2006,"18 to 20","2806","48","57","29","2940"
"Natrona",2006,"21 to 24","3987","71","79","47","4184"
"Natrona",2006,"25 & over","45052","441","505","324","46322"
"Natrona",2006,"Total","68365","949","946","546","70806"
"Crook",2006,"0","90","1","0","0","91"
"Crook",2006,"1","71","0","1","0","72"
"Crook",2006,"2","73","2","0","0","75"
"Crook",2006,"3","57","1","1","1","60"
"Crook",2006,"4","69","0","1","1","71"
"Crook",2006,"5","70","2","0","0","72"
"Crook",2006,"6","78","1","2","0","81"
"Crook",2006,"7","84","2","0","0","86"
"Crook",2006,"8","68","1","1","0","70"
"Crook",2006,"9","64","0","1","0","65"
"Crook",2006,"10","86","1","0","0","87"
"Crook",2006,"11","70","1","3","0","74"
"Crook",2006,"12","86","0","0","0","86"
"Crook",2006,"13","93","0","1","0","94"
"Crook",2006,"14","88","0","0","0","88"
"Crook",2006,"15","116","0","2","0","118"
"Crook",2006,"16","101","1","0","0","102"
"Crook",2006,"17","94","0","1","0","95"
"Crook",2006,"18 to 20","224","0","1","0","225"
"Crook",2006,"21 to 24","243","0","3","0","246"
"Crook",2006,"25 & over","4284","6","33","5","4328"
"Crook",2006,"Total","6209","19","51","7","6286"
"Carbon",2006,"0","185","4","5","1","195"
"Carbon",2006,"1","198","3","3","0","204"
"Carbon",2006,"2","169","2","1","2","174"
"Carbon",2006,"3","198","5","2","1","206"
"Carbon",2006,"4","158","4","2","6","170"
"Carbon",2006,"5","173","6","5","3","187"
"Carbon",2006,"6","176","4","3","1","184"
"Carbon",2006,"7","181","3","2","0","186"
"Carbon",2006,"8","201","1","5","2","209"
"Carbon",2006,"9","184","2","5","2","193"
"Carbon",2006,"10","164","1","4","3","172"
"Carbon",2006,"11","165","2","5","1","173"
"Carbon",2006,"12","165","1","1","1","168"
"Carbon",2006,"13","180","2","4","2","188"
"Carbon",2006,"14","175","1","4","1","181"
"Carbon",2006,"15","202","0","6","3","211"
"Carbon",2006,"16","216","3","1","2","222"
"Carbon",2006,"17","207","0","7","2","216"
"Carbon",2006,"18 to 20","493","6","5","5","509"
"Carbon",2006,"21 to 24","724","10","14","6","754"
"Carbon",2006,"25 & over","10121","85","138","90","10434"
"Carbon",2006,"Total","14635","145","222","134","15136"
"Uinta",2012,"0","304","6","4","0","314"
"Uinta",2012,"1","305","9","9","4","327"
"Uinta",2012,"2","321","4","8","3","336"
"Uinta",2012,"3","329","3","5","4","341"
"Uinta",2012,"4","347","7","3","2","359"
"Uinta",2012,"5","345","3","6","1","355"
"Uinta",2012,"6","358","5","3","4","370"
"Uinta",2012,"7","337","1","4","5","347"
"Uinta",2012,"8","358","2","8","4","372"
"Uinta",2012,"9","330","3","3","4","340"
"Uinta",2012,"10","363","6","5","4","378"
"Uinta",2012,"11","330","5","3","3","341"
"Uinta",2012,"12","353","3","4","0","360"
"Uinta",2012,"13","325","4","4","4","337"
"Uinta",2012,"14","351","1","7","2","361"
"Uinta",2012,"15","343","2","2","2","349"
"Uinta",2012,"16","299","2","5","4","310"
"Uinta",2012,"17","302","6","5","1","314"
"Uinta",2012,"18 to 20","739","18","14","4","775"
"Uinta",2012,"21 to 24","858","13","21","7","899"
"Uinta",2012,"25 & over","12796","72","163","81","13112"
"Uinta",2012,"Total","20393","175","286","143","20997"
"Sheridan",2004,"0","312","4","11","1","328"
"Sheridan",2004,"1","331","1","7","3","342"
"Sheridan",2004,"2","280","1","6","2","289"
"Sheridan",2004,"3","271","2","8","1","282"
"Sheridan",2004,"4","346","1","8","2","357"
"Sheridan",2004,"5","244","1","4","3","252"
"Sheridan",2004,"6","286","3","8","1","298"
"Sheridan",2004,"7","290","2","6","3","301"
"Sheridan",2004,"8","268","3","8","2","281"
"Sheridan",2004,"9","289","2","2","2","295"
"Sheridan",2004,"10","328","2","9","2","341"
"Sheridan",2004,"11","360","3","7","2","372"
"Sheridan",2004,"12","306","2","10","1","319"
"Sheridan",2004,"13","334","4","7","2","347"
"Sheridan",2004,"14","376","0","13","4","393"
"Sheridan",2004,"15","404","5","12","4","425"
"Sheridan",2004,"16","391","3","13","4","411"
"Sheridan",2004,"17","401","2","12","2","417"
"Sheridan",2004,"18 to 20","1091","10","26","8","1135"
"Sheridan",2004,"21 to 24","1231","6","23","12","1272"
"Sheridan",2004,"25 & over","18112","36","225","112","18485"
"Sheridan",2004,"Total","26251","93","425","173","26942"
"Goshen",2015,"0","146","5","3","2","156"
"Goshen",2015,"1","150","6","4","1","161"
"Goshen",2015,"2","124","4","15","1","144"
"Goshen",2015,"3","134","1","5","0","140"
"Goshen",2015,"4","130","3","0","2","135"
"Goshen",2015,"5","159","2","3","2","166"
"Goshen",2015,"6","161","2","5","2","170"
"Goshen",2015,"7","142","4","3","2","151"
"Goshen",2015,"8","159","3","3","0","165"
"Goshen",2015,"9","131","3","1","1","136"
"Goshen",2015,"10","124","0","2","0","126"
"Goshen",2015,"11","163","1","1","1","166"
"Goshen",2015,"12","143","1","4","3","151"
"Goshen",2015,"13","145","1","0","1","147"
"Goshen",2015,"14","158","0","3","1","162"
"Goshen",2015,"15","169","5","2","2","178"
"Goshen",2015,"16","157","3","0","1","161"
"Goshen",2015,"17","158","3","2","2","165"
"Goshen",2015,"18 to 20","553","18","6","5","582"
"Goshen",2015,"21 to 24","671","16","17","7","711"
"Goshen",2015,"25 & over","9297","91","82","49","9519"
"Goshen",2015,"Total","13174","172","161","85","13592"
"Johnson",1994,"0","66","0","1","0","67"
"Johnson",1994,"1","77","0","0","0","77"
"Johnson",1994,"2","71","0","0","0","71"
"Johnson",1994,"3","73","0","0","0","73"
"Johnson",1994,"4","77","0","0","0","77"
"Johnson",1994,"5","79","0","1","0","80"
"Johnson",1994,"6","79","0","3","0","82"
"Johnson",1994,"7","90","0","0","0","90"
"Johnson",1994,"8","89","0","4","0","93"
"Johnson",1994,"9","104","0","2","0","106"
"Johnson",1994,"10","109","0","1","0","110"
"Johnson",1994,"11","110","0","0","0","110"
"Johnson",1994,"12","106","0","0","0","106"
"Johnson",1994,"13","98","0","1","0","99"
"Johnson",1994,"14","115","0","6","0","121"
"Johnson",1994,"15","103","0","2","1","106"
"Johnson",1994,"16","119","0","0","0","119"
"Johnson",1994,"17","111","0","0","0","111"
"Johnson",1994,"18 to 20","200","0","0","0","200"
"Johnson",1994,"21 to 24","196","0","0","0","196"
"Johnson",1994,"25 & over","4427","0","12","0","4439"
"Johnson",1994,"Total","6499","0","33","1","6533"
"Converse",2003,"0","152","0","2","1","155"
"Converse",2003,"1","137","2","3","1","143"
"Converse",2003,"2","151","1","1","0","153"
"Converse",2003,"3","154","2","3","0","159"
"Converse",2003,"4","152","2","3","0","157"
"Converse",2003,"5","155","3","2","0","160"
"Converse",2003,"6","161","1","1","0","163"
"Converse",2003,"7","173","3","4","1","181"
"Converse",2003,"8","174","1","0","0","175"
"Converse",2003,"9","157","2","2","1","162"
"Converse",2003,"10","176","4","2","2","184"
"Converse",2003,"11","203","2","3","0","208"
"Converse",2003,"12","184","5","3","0","192"
"Converse",2003,"13","213","1","1","2","217"
"Converse",2003,"14","202","4","2","1","209"
"Converse",2003,"15","185","0","0","1","186"
"Converse",2003,"16","252","0","2","1","255"
"Converse",2003,"17","234","2","3","2","241"
"Converse",2003,"18 to 20","475","1","5","3","484"
"Converse",2003,"21 to 24","490","0","5","2","497"
"Converse",2003,"25 & over","7842","8","75","26","7951"
"Converse",2003,"Total","12022","44","122","44","12232"
"Sheridan",2008,"0","338","3","4","1","346"
"Sheridan",2008,"1","352","1","6","2","361"
"Sheridan",2008,"2","312","2","4","2","320"
"Sheridan",2008,"3","322","3","12","5","342"
"Sheridan",2008,"4","337","5","6","4","352"
"Sheridan",2008,"5","345","2","5","2","354"
"Sheridan",2008,"6","295","3","10","0","308"
"Sheridan",2008,"7","328","3","11","4","346"
"Sheridan",2008,"8","356","0","3","2","361"
"Sheridan",2008,"9","285","4","4","1","294"
"Sheridan",2008,"10","329","3","7","2","341"
"Sheridan",2008,"11","332","4","8","3","347"
"Sheridan",2008,"12","321","3","9","1","334"
"Sheridan",2008,"13","321","3","2","2","328"
"Sheridan",2008,"14","328","1","11","4","344"
"Sheridan",2008,"15","416","6","14","4","440"
"Sheridan",2008,"16","342","5","23","2","372"
"Sheridan",2008,"17","392","4","18","2","416"
"Sheridan",2008,"18 to 20","1051","15","23","16","1105"
"Sheridan",2008,"21 to 24","1180","15","21","18","1234"
"Sheridan",2008,"25 & over","19408","62","213","137","19820"
"Sheridan",2008,"Total","27690","147","414","214","28465"
"Carbon",1997,"0","175","0","0","2","177"
"Carbon",1997,"1","189","0","8","1","198"
"Carbon",1997,"2","180","2","0","0","182"
"Carbon",1997,"3","179","0","3","0","182"
"Carbon",1997,"4","188","0","0","0","188"
"Carbon",1997,"5","197","2","8","0","207"
"Carbon",1997,"6","197","0","3","0","200"
"Carbon",1997,"7","210","0","0","1","211"
"Carbon",1997,"8","205","2","8","1","216"
"Carbon",1997,"9","198","0","0","4","202"
"Carbon",1997,"10","222","2","6","2","232"
"Carbon",1997,"11","231","4","4","0","239"
"Carbon",1997,"12","253","3","0","4","260"
"Carbon",1997,"13","257","0","0","0","257"
"Carbon",1997,"14","278","0","0","3","281"
"Carbon",1997,"15","280","0","0","9","289"
"Carbon",1997,"16","282","0","0","4","286"
"Carbon",1997,"17","307","0","1","2","310"
"Carbon",1997,"18 to 20","569","6","14","3","592"
"Carbon",1997,"21 to 24","722","7","14","5","748"
"Carbon",1997,"25 & over","10240","61","104","52","10457"
"Carbon",1997,"Total","15559","89","173","93","15914"
"Weston",2008,"0","72","0","3","1","76"
"Weston",2008,"1","76","1","0","1","78"
"Weston",2008,"2","64","1","2","1","68"
"Weston",2008,"3","71","2","4","0","77"
"Weston",2008,"4","90","1","2","0","93"
"Weston",2008,"5","88","2","2","0","92"
"Weston",2008,"6","82","0","3","0","85"
"Weston",2008,"7","80","1","2","1","84"
"Weston",2008,"8","81","2","1","1","85"
"Weston",2008,"9","93","0","1","0","94"
"Weston",2008,"10","74","1","0","1","76"
"Weston",2008,"11","76","0","2","0","78"
"Weston",2008,"12","71","0","2","0","73"
"Weston",2008,"13","87","2","3","0","92"
"Weston",2008,"14","80","0","1","0","81"
"Weston",2008,"15","80","0","3","0","83"
"Weston",2008,"16","90","0","2","0","92"
"Weston",2008,"17","90","1","0","0","91"
"Weston",2008,"18 to 20","220","2","6","1","229"
"Weston",2008,"21 to 24","361","4","2","1","368"
"Weston",2008,"25 & over","4932","16","72","18","5038"
"Weston",2008,"Total","6958","36","113","26","7133"
"Niobrara",2010,"0","18","1","0","0","19"
"Niobrara",2010,"1","22","0","0","0","22"
"Niobrara",2010,"2","19","0","0","0","19"
"Niobrara",2010,"3","18","0","0","0","18"
"Niobrara",2010,"4","17","0","1","0","18"
"Niobrara",2010,"5","20","0","0","0","20"
"Niobrara",2010,"6","22","0","0","0","22"
"Niobrara",2010,"7","35","0","0","0","35"
"Niobrara",2010,"8","24","0","0","0","24"
"Niobrara",2010,"9","33","0","0","0","33"
"Niobrara",2010,"10","26","1","0","0","27"
"Niobrara",2010,"11","33","0","0","0","33"
"Niobrara",2010,"12","30","1","0","0","31"
"Niobrara",2010,"13","32","0","0","0","32"
"Niobrara",2010,"14","27","0","0","1","28"
"Niobrara",2010,"15","29","1","0","0","30"
"Niobrara",2010,"16","23","1","0","0","24"
"Niobrara",2010,"17","32","0","0","1","33"
"Niobrara",2010,"18 to 20","53","0","0","0","53"
"Niobrara",2010,"21 to 24","90","2","3","0","95"
"Niobrara",2010,"25 & over","1842","9","18","7","1876"
"Niobrara",2010,"Total","2445","16","22","9","2492"
"Carbon",2004,"0","196","2","3","2","203"
"Carbon",2004,"1","189","2","4","0","195"
"Carbon",2004,"2","168","3","1","3","175"
"Carbon",2004,"3","174","3","3","1","181"
"Carbon",2004,"4","157","4","2","2","165"
"Carbon",2004,"5","182","3","2","2","189"
"Carbon",2004,"6","189","4","3","1","197"
"Carbon",2004,"7","168","1","2","1","172"
"Carbon",2004,"8","166","2","5","2","175"
"Carbon",2004,"9","170","2","3","1","176"
"Carbon",2004,"10","183","2","6","1","192"
"Carbon",2004,"11","172","2","4","1","179"
"Carbon",2004,"12","176","1","0","2","179"
"Carbon",2004,"13","205","2","2","0","209"
"Carbon",2004,"14","191","2","2","1","196"
"Carbon",2004,"15","191","2","4","3","200"
"Carbon",2004,"16","192","3","2","4","201"
"Carbon",2004,"17","216","0","6","2","224"
"Carbon",2004,"18 to 20","560","8","9","5","582"
"Carbon",2004,"21 to 24","778","8","16","8","810"
"Carbon",2004,"25 & over","10122","76","135","103","10436"
"Carbon",2004,"Total","14745","132","214","145","15236"
"Uinta",2006,"0","319","4","12","1","336"
"Uinta",2006,"1","250","1","3","2","256"
"Uinta",2006,"2","349","2","1","1","353"
"Uinta",2006,"3","319","2","1","1","323"
"Uinta",2006,"4","306","3","2","9","320"
"Uinta",2006,"5","294","4","3","2","303"
"Uinta",2006,"6","322","2","4","0","328"
"Uinta",2006,"7","302","2","4","1","309"
"Uinta",2006,"8","326","4","2","1","333"
"Uinta",2006,"9","304","4","2","2","312"
"Uinta",2006,"10","337","3","2","2","344"
"Uinta",2006,"11","296","3","6","2","307"
"Uinta",2006,"12","354","2","7","1","364"
"Uinta",2006,"13","316","1","2","1","320"
"Uinta",2006,"14","298","2","5","2","307"
"Uinta",2006,"15","329","3","6","1","339"
"Uinta",2006,"16","376","3","6","3","388"
"Uinta",2006,"17","366","3","5","2","376"
"Uinta",2006,"18 to 20","772","7","19","3","801"
"Uinta",2006,"21 to 24","932","2","7","5","946"
"Uinta",2006,"25 & over","11824","37","128","55","12044"
"Uinta",2006,"Total","19291","94","227","97","19709"
"Albany",1991,"0","359","2","3","11","375"
"Albany",1991,"1","361","13","5","13","392"
"Albany",1991,"2","363","3","5","15","386"
"Albany",1991,"3","356","0","6","5","367"
"Albany",1991,"4","361","7","3","7","378"
"Albany",1991,"5","364","3","3","8","378"
"Albany",1991,"6","371","3","6","3","383"
"Albany",1991,"7","358","4","4","7","373"
"Albany",1991,"8","370","8","4","1","383"
"Albany",1991,"9","384","4","6","6","400"
"Albany",1991,"10","393","2","5","0","400"
"Albany",1991,"11","364","2","3","8","377"
"Albany",1991,"12","341","6","3","10","360"
"Albany",1991,"13","331","3","9","4","347"
"Albany",1991,"14","312","0","5","2","319"
"Albany",1991,"15","307","1","8","5","321"
"Albany",1991,"16","336","0","5","2","343"
"Albany",1991,"17","323","7","2","6","338"
"Albany",1991,"18 to 20","4014","60","19","60","4153"
"Albany",1991,"21 to 24","4026","35","24","118","4203"
"Albany",1991,"25 & over","15755","104","103","347","16309"
"Albany",1991,"Total","30149","267","231","638","31285"
"Campbell",2005,"0","605","4","23","5","637"
"Campbell",2005,"1","563","5","15","1","584"
"Campbell",2005,"2","574","3","8","2","587"
"Campbell",2005,"3","528","4","31","7","570"
"Campbell",2005,"4","533","5","9","5","552"
"Campbell",2005,"5","589","3","14","0","606"
"Campbell",2005,"6","590","5","13","4","612"
"Campbell",2005,"7","566","5","10","2","583"
"Campbell",2005,"8","540","6","10","1","557"
"Campbell",2005,"9","547","5","7","4","563"
"Campbell",2005,"10","524","6","8","2","540"
"Campbell",2005,"11","577","2","12","4","595"
"Campbell",2005,"12","606","5","7","5","623"
"Campbell",2005,"13","608","8","13","2","631"
"Campbell",2005,"14","600","7","7","7","621"
"Campbell",2005,"15","615","3","14","0","632"
"Campbell",2005,"16","608","3","10","3","624"
"Campbell",2005,"17","613","5","15","2","635"
"Campbell",2005,"18 to 20","1655","20","40","11","1726"
"Campbell",2005,"21 to 24","2153","11","40","16","2220"
"Campbell",2005,"25 & over","22697","74","279","140","23190"
"Campbell",2005,"Total","36891","189","585","223","37888"
"Big Horn",2006,"0","143","2","4","0","149"
"Big Horn",2006,"1","148","0","3","0","151"
"Big Horn",2006,"2","113","2","0","0","115"
"Big Horn",2006,"3","156","0","2","0","158"
"Big Horn",2006,"4","141","0","1","1","143"
"Big Horn",2006,"5","160","0","0","0","160"
"Big Horn",2006,"6","158","0","0","1","159"
"Big Horn",2006,"7","142","1","0","2","145"
"Big Horn",2006,"8","162","2","1","0","165"
"Big Horn",2006,"9","136","1","2","1","140"
"Big Horn",2006,"10","165","1","5","2","173"
"Big Horn",2006,"11","162","2","1","0","165"
"Big Horn",2006,"12","163","0","1","0","164"
"Big Horn",2006,"13","154","0","0","1","155"
"Big Horn",2006,"14","182","3","3","0","188"
"Big Horn",2006,"15","217","3","2","2","224"
"Big Horn",2006,"16","189","1","1","0","191"
"Big Horn",2006,"17","173","2","3","0","178"
"Big Horn",2006,"18 to 20","351","6","4","1","362"
"Big Horn",2006,"21 to 24","431","4","8","0","443"
"Big Horn",2006,"25 & over","7372","20","79","23","7494"
"Big Horn",2006,"Total","11018","50","120","34","11222"
"Teton",2005,"0","249","2","3","1","255"
"Teton",2005,"1","205","2","2","0","209"
"Teton",2005,"2","212","3","2","2","219"
"Teton",2005,"3","166","1","1","8","176"
"Teton",2005,"4","156","3","2","2","163"
"Teton",2005,"5","157","3","2","3","165"
"Teton",2005,"6","164","3","0","3","170"
"Teton",2005,"7","177","3","1","3","184"
"Teton",2005,"8","189","1","3","3","196"
"Teton",2005,"9","168","1","0","1","170"
"Teton",2005,"10","206","2","2","5","215"
"Teton",2005,"11","207","1","1","1","210"
"Teton",2005,"12","190","1","1","3","195"
"Teton",2005,"13","224","1","1","1","227"
"Teton",2005,"14","220","0","2","5","227"
"Teton",2005,"15","256","1","2","2","261"
"Teton",2005,"16","228","0","1","2","231"
"Teton",2005,"17","219","0","3","4","226"
"Teton",2005,"18 to 20","518","5","6","6","535"
"Teton",2005,"21 to 24","1183","6","12","13","1214"
"Teton",2005,"25 & over","13912","44","92","136","14184"
"Teton",2005,"Total","19206","83","139","204","19632"
"Sweetwater",2006,"0","621","23","12","2","658"
"Sweetwater",2006,"1","609","14","15","3","641"
"Sweetwater",2006,"2","567","13","9","4","593"
"Sweetwater",2006,"3","634","14","7","4","659"
"Sweetwater",2006,"4","562","8","17","9","596"
"Sweetwater",2006,"5","536","17","13","5","571"
"Sweetwater",2006,"6","535","4","7","4","550"
"Sweetwater",2006,"7","542","14","7","8","571"
"Sweetwater",2006,"8","528","6","6","6","546"
"Sweetwater",2006,"9","540","8","8","7","563"
"Sweetwater",2006,"10","497","6","11","3","517"
"Sweetwater",2006,"11","491","12","8","3","514"
"Sweetwater",2006,"12","522","11","7","3","543"
"Sweetwater",2006,"13","552","8","11","6","577"
"Sweetwater",2006,"14","590","8","9","5","612"
"Sweetwater",2006,"15","609","7","8","4","628"
"Sweetwater",2006,"16","578","7","11","5","601"
"Sweetwater",2006,"17","542","6","14","6","568"
"Sweetwater",2006,"18 to 20","1751","33","29","23","1836"
"Sweetwater",2006,"21 to 24","2491","43","39","37","2610"
"Sweetwater",2006,"25 & over","24013","255","283","244","24795"
"Sweetwater",2006,"Total","38310","517","531","391","39749"
"Laramie",2015,"0","1148","80","28","26","1282"
"Laramie",2015,"1","1089","79","24","28","1220"
"Laramie",2015,"2","1209","69","26","23","1327"
"Laramie",2015,"3","1114","68","27","24","1233"
"Laramie",2015,"4","1166","69","24","13","1272"
"Laramie",2015,"5","1175","61","24","16","1276"
"Laramie",2015,"6","1220","60","29","22","1331"
"Laramie",2015,"7","1266","61","34","30","1391"
"Laramie",2015,"8","1248","53","13","26","1340"
"Laramie",2015,"9","1221","61","33","26","1341"
"Laramie",2015,"10","1178","57","23","28","1286"
"Laramie",2015,"11","1218","33","29","32","1312"
"Laramie",2015,"12","1164","57","27","22","1270"
"Laramie",2015,"13","1118","38","23","21","1200"
"Laramie",2015,"14","1097","60","26","25","1208"
"Laramie",2015,"15","1145","61","17","12","1235"
"Laramie",2015,"16","1112","57","35","19","1223"
"Laramie",2015,"17","1084","67","21","23","1195"
"Laramie",2015,"18 to 20","3104","221","48","68","3441"
"Laramie",2015,"21 to 24","5228","465","106","141","5940"
"Laramie",2015,"25 & over","61240","1782","803","1035","64860"
"Laramie",2015,"Total","90544","3559","1420","1660","97183"
"Big Horn",2001,"0","130","0","1","0","131"
"Big Horn",2001,"1","159","0","1","1","161"
"Big Horn",2001,"2","140","0","1","0","141"
"Big Horn",2001,"3","155","0","1","0","156"
"Big Horn",2001,"4","130","1","1","0","132"
"Big Horn",2001,"5","160","2","1","0","163"
"Big Horn",2001,"6","168","0","2","1","171"
"Big Horn",2001,"7","165","0","0","0","165"
"Big Horn",2001,"8","157","0","1","0","158"
"Big Horn",2001,"9","174","0","2","0","176"
"Big Horn",2001,"10","201","0","3","0","204"
"Big Horn",2001,"11","180","1","2","0","183"
"Big Horn",2001,"12","175","0","5","0","180"
"Big Horn",2001,"13","207","0","3","2","212"
"Big Horn",2001,"14","196","1","3","1","201"
"Big Horn",2001,"15","201","1","2","1","205"
"Big Horn",2001,"16","174","2","2","1","179"
"Big Horn",2001,"17","214","1","2","2","219"
"Big Horn",2001,"18 to 20","422","0","5","1","428"
"Big Horn",2001,"21 to 24","345","1","3","0","349"
"Big Horn",2001,"25 & over","7218","4","54","19","7295"
"Big Horn",2001,"Total","11071","14","95","29","11209"
"Weston",1991,"0","74","0","2","0","76"
"Weston",1991,"1","83","0","0","0","83"
"Weston",1991,"2","87","0","2","0","89"
"Weston",1991,"3","82","0","1","0","83"
"Weston",1991,"4","89","0","2","0","91"
"Weston",1991,"5","99","0","0","0","99"
"Weston",1991,"6","108","0","0","0","108"
"Weston",1991,"7","117","0","0","0","117"
"Weston",1991,"8","118","0","0","0","118"
"Weston",1991,"9","133","0","5","0","138"
"Weston",1991,"10","122","0","5","0","127"
"Weston",1991,"11","138","0","1","0","139"
"Weston",1991,"12","119","0","0","0","119"
"Weston",1991,"13","128","0","0","0","128"
"Weston",1991,"14","108","0","0","0","108"
"Weston",1991,"15","120","0","0","0","120"
"Weston",1991,"16","93","0","0","0","93"
"Weston",1991,"17","89","0","2","0","91"
"Weston",1991,"18 to 20","193","0","13","0","206"
"Weston",1991,"21 to 24","212","0","6","0","218"
"Weston",1991,"25 & over","4133","0","27","4","4164"
"Weston",1991,"Total","6445","0","66","4","6515"
"Johnson",1996,"0","64","0","1","0","65"
"Johnson",1996,"1","77","0","0","0","77"
"Johnson",1996,"2","71","0","0","0","71"
"Johnson",1996,"3","74","0","0","0","74"
"Johnson",1996,"4","75","0","0","0","75"
"Johnson",1996,"5","80","0","1","0","81"
"Johnson",1996,"6","86","0","4","0","90"
"Johnson",1996,"7","92","0","0","0","92"
"Johnson",1996,"8","87","0","4","0","91"
"Johnson",1996,"9","98","0","2","0","100"
"Johnson",1996,"10","107","0","2","0","109"
"Johnson",1996,"11","111","0","0","0","111"
"Johnson",1996,"12","100","0","0","0","100"
"Johnson",1996,"13","99","0","1","0","100"
"Johnson",1996,"14","118","0","4","0","122"
"Johnson",1996,"15","108","0","2","1","111"
"Johnson",1996,"16","127","0","0","0","127"
"Johnson",1996,"17","126","0","0","0","126"
"Johnson",1996,"18 to 20","211","0","0","0","211"
"Johnson",1996,"21 to 24","194","0","0","0","194"
"Johnson",1996,"25 & over","4629","0","16","0","4645"
"Johnson",1996,"Total","6734","0","37","1","6772"
"Uinta",2002,"0","299","3","7","0","309"
"Uinta",2002,"1","284","1","4","1","290"
"Uinta",2002,"2","299","1","2","0","302"
"Uinta",2002,"3","305","0","0","1","306"
"Uinta",2002,"4","319","5","2","3","329"
"Uinta",2002,"5","318","2","4","3","327"
"Uinta",2002,"6","336","2","3","2","343"
"Uinta",2002,"7","281","4","5","3","293"
"Uinta",2002,"8","330","3","2","1","336"
"Uinta",2002,"9","291","1","2","2","296"
"Uinta",2002,"10","322","3","2","1","328"
"Uinta",2002,"11","341","1","3","4","349"
"Uinta",2002,"12","396","1","7","1","405"
"Uinta",2002,"13","359","0","3","1","363"
"Uinta",2002,"14","383","1","9","3","396"
"Uinta",2002,"15","380","1","11","0","392"
"Uinta",2002,"16","414","1","5","2","422"
"Uinta",2002,"17","410","1","5","2","418"
"Uinta",2002,"18 to 20","945","2","18","2","967"
"Uinta",2002,"21 to 24","889","0","8","4","901"
"Uinta",2002,"25 & over","11334","16","115","50","11515"
"Uinta",2002,"Total","19235","49","217","86","19587"
"Sheridan",2006,"0","292","3","6","0","301"
"Sheridan",2006,"1","308","1","6","3","318"
"Sheridan",2006,"2","327","2","7","1","337"
"Sheridan",2006,"3","332","3","7","3","345"
"Sheridan",2006,"4","295","2","6","3","306"
"Sheridan",2006,"5","279","2","11","2","294"
"Sheridan",2006,"6","324","3","10","0","337"
"Sheridan",2006,"7","272","4","4","2","282"
"Sheridan",2006,"8","288","0","4","2","294"
"Sheridan",2006,"9","280","3","8","1","292"
"Sheridan",2006,"10","284","3","10","1","298"
"Sheridan",2006,"11","292","3","5","2","302"
"Sheridan",2006,"12","321","2","9","1","333"
"Sheridan",2006,"13","378","3","6","1","388"
"Sheridan",2006,"14","307","1","12","4","324"
"Sheridan",2006,"15","362","4","16","5","387"
"Sheridan",2006,"16","378","4","12","3","397"
"Sheridan",2006,"17","403","3","9","1","416"
"Sheridan",2006,"18 to 20","1025","13","24","14","1076"
"Sheridan",2006,"21 to 24","1231","12","22","18","1283"
"Sheridan",2006,"25 & over","18708","57","224","123","19112"
"Sheridan",2006,"Total","26686","128","418","190","27422"
"Sweetwater",1995,"0","533","7","5","2","547"
"Sweetwater",1995,"1","569","5","6","3","583"
"Sweetwater",1995,"2","549","8","13","1","571"
"Sweetwater",1995,"3","560","12","9","1","582"
"Sweetwater",1995,"4","560","4","7","1","572"
"Sweetwater",1995,"5","583","11","6","4","604"
"Sweetwater",1995,"6","633","8","11","3","655"
"Sweetwater",1995,"7","641","5","11","4","661"
"Sweetwater",1995,"8","667","2","4","3","676"
"Sweetwater",1995,"9","741","2","7","4","754"
"Sweetwater",1995,"10","732","3","13","1","749"
"Sweetwater",1995,"11","750","8","8","5","771"
"Sweetwater",1995,"12","805","5","6","3","819"
"Sweetwater",1995,"13","854","4","9","2","869"
"Sweetwater",1995,"14","795","9","10","1","815"
"Sweetwater",1995,"15","783","13","10","1","807"
"Sweetwater",1995,"16","779","6","10","5","800"
"Sweetwater",1995,"17","783","3","8","5","799"
"Sweetwater",1995,"18 to 20","1838","18","14","17","1887"
"Sweetwater",1995,"21 to 24","1805","19","20","23","1867"
"Sweetwater",1995,"25 & over","22950","159","194","158","23461"
"Sweetwater",1995,"Total","38910","311","381","247","39849"
"Big Horn",2009,"0","137","2","5","0","144"
"Big Horn",2009,"1","155","0","4","0","159"
"Big Horn",2009,"2","143","3","0","0","146"
"Big Horn",2009,"3","175","0","3","0","178"
"Big Horn",2009,"4","159","0","1","2","162"
"Big Horn",2009,"5","157","0","0","0","157"
"Big Horn",2009,"6","165","0","0","1","166"
"Big Horn",2009,"7","139","1","0","2","142"
"Big Horn",2009,"8","176","2","0","0","178"
"Big Horn",2009,"9","141","1","1","1","144"
"Big Horn",2009,"10","155","1","5","2","163"
"Big Horn",2009,"11","162","3","1","0","166"
"Big Horn",2009,"12","168","1","0","1","170"
"Big Horn",2009,"13","165","0","0","1","166"
"Big Horn",2009,"14","158","3","4","0","165"
"Big Horn",2009,"15","197","3","1","1","202"
"Big Horn",2009,"16","169","0","0","0","169"
"Big Horn",2009,"17","195","1","3","0","199"
"Big Horn",2009,"18 to 20","336","9","6","2","353"
"Big Horn",2009,"21 to 24","432","5","11","0","448"
"Big Horn",2009,"25 & over","7618","26","95","25","7764"
"Big Horn",2009,"Total","11302","61","140","38","11541"
"Crook",1999,"0","62","0","0","0","62"
"Crook",1999,"1","64","0","3","0","67"
"Crook",1999,"2","60","0","0","0","60"
"Crook",1999,"3","54","0","0","0","54"
"Crook",1999,"4","62","0","0","0","62"
"Crook",1999,"5","71","0","3","0","74"
"Crook",1999,"6","81","0","0","0","81"
"Crook",1999,"7","82","0","0","0","82"
"Crook",1999,"8","81","0","0","0","81"
"Crook",1999,"9","84","0","0","0","84"
"Crook",1999,"10","94","0","6","0","100"
"Crook",1999,"11","104","0","0","0","104"
"Crook",1999,"12","95","0","0","0","95"
"Crook",1999,"13","113","0","0","0","113"
"Crook",1999,"14","109","0","0","0","109"
"Crook",1999,"15","109","0","7","0","116"
"Crook",1999,"16","120","0","0","0","120"
"Crook",1999,"17","125","0","0","0","125"
"Crook",1999,"18 to 20","225","0","3","0","228"
"Crook",1999,"21 to 24","181","0","0","0","181"
"Crook",1999,"25 & over","3836","0","15","0","3851"
"Crook",1999,"Total","5812","0","37","0","5849"
"Park",2011,"0","291","3","1","1","296"
"Park",2011,"1","287","2","4","4","297"
"Park",2011,"2","322","2","4","1","329"
"Park",2011,"3","362","1","2","3","368"
"Park",2011,"4","333","3","2","4","342"
"Park",2011,"5","345","2","7","2","356"
"Park",2011,"6","319","2","4","3","328"
"Park",2011,"7","333","3","3","0","339"
"Park",2011,"8","318","3","3","3","327"
"Park",2011,"9","306","1","6","0","313"
"Park",2011,"10","309","1","4","2","316"
"Park",2011,"11","313","3","7","2","325"
"Park",2011,"12","300","3","5","1","309"
"Park",2011,"13","346","2","6","3","357"
"Park",2011,"14","332","4","7","7","350"
"Park",2011,"15","327","1","4","3","335"
"Park",2011,"16","337","2","4","1","344"
"Park",2011,"17","321","3","5","2","331"
"Park",2011,"18 to 20","1156","39","25","23","1243"
"Park",2011,"21 to 24","1160","18","12","21","1211"
"Park",2011,"25 & over","19754","53","131","122","20060"
"Park",2011,"Total","27871","151","246","208","28476"
"Crook",2012,"0","97","2","1","0","100"
"Crook",2012,"1","85","0","0","0","85"
"Crook",2012,"2","105","0","0","0","105"
"Crook",2012,"3","84","0","0","0","84"
"Crook",2012,"4","101","1","0","1","103"
"Crook",2012,"5","98","2","1","1","102"
"Crook",2012,"6","85","0","1","1","87"
"Crook",2012,"7","94","1","0","0","95"
"Crook",2012,"8","88","2","1","0","91"
"Crook",2012,"9","90","1","0","0","91"
"Crook",2012,"10","93","2","1","1","97"
"Crook",2012,"11","78","2","5","0","85"
"Crook",2012,"12","84","3","1","0","88"
"Crook",2012,"13","82","1","2","0","85"
"Crook",2012,"14","77","2","0","0","79"
"Crook",2012,"15","90","0","1","0","91"
"Crook",2012,"16","104","1","1","0","106"
"Crook",2012,"17","87","1","1","0","89"
"Crook",2012,"18 to 20","205","4","3","1","213"
"Crook",2012,"21 to 24","250","1","2","0","253"
"Crook",2012,"25 & over","4910","71","35","7","5023"
"Crook",2012,"Total","6987","97","56","12","7152"
"Platte",1999,"0","99","0","0","0","99"
"Platte",1999,"1","96","0","1","0","97"
"Platte",1999,"2","84","0","0","0","84"
"Platte",1999,"3","93","0","0","0","93"
"Platte",1999,"4","89","0","1","0","90"
"Platte",1999,"5","125","1","1","1","128"
"Platte",1999,"6","99","0","0","0","99"
"Platte",1999,"7","122","0","0","0","122"
"Platte",1999,"8","131","0","0","0","131"
"Platte",1999,"9","123","0","0","0","123"
"Platte",1999,"10","150","4","0","0","154"
"Platte",1999,"11","130","0","1","0","131"
"Platte",1999,"12","151","0","0","0","151"
"Platte",1999,"13","151","0","0","0","151"
"Platte",1999,"14","141","0","0","0","141"
"Platte",1999,"15","164","0","0","0","164"
"Platte",1999,"16","166","0","0","0","166"
"Platte",1999,"17","161","0","0","0","161"
"Platte",1999,"18 to 20","286","0","0","1","287"
"Platte",1999,"21 to 24","290","0","0","0","290"
"Platte",1999,"25 & over","5989","0","14","1","6004"
"Platte",1999,"Total","8840","5","18","3","8866"
"Teton",2010,"0","259","2","2","2","265"
"Teton",2010,"1","256","3","3","1","263"
"Teton",2010,"2","265","4","4","4","277"
"Teton",2010,"3","251","1","3","6","261"
"Teton",2010,"4","227","2","4","3","236"
"Teton",2010,"5","232","2","4","4","242"
"Teton",2010,"6","219","4","2","3","228"
"Teton",2010,"7","211","3","2","5","221"
"Teton",2010,"8","197","4","3","4","208"
"Teton",2010,"9","182","2","2","5","191"
"Teton",2010,"10","207","3","3","7","220"
"Teton",2010,"11","188","1","4","2","195"
"Teton",2010,"12","205","2","5","6","218"
"Teton",2010,"13","209","2","2","5","218"
"Teton",2010,"14","188","2","1","3","194"
"Teton",2010,"15","209","2","3","6","220"
"Teton",2010,"16","218","0","2","1","221"
"Teton",2010,"17","199","3","4","1","207"
"Teton",2010,"18 to 20","430","10","7","8","455"
"Teton",2010,"21 to 24","1165","5","16","15","1201"
"Teton",2010,"25 & over","15166","58","144","188","15556"
"Teton",2010,"Total","20683","115","220","279","21297"
"Weston",2013,"0","86","3","3","0","92"
"Weston",2013,"1","76","1","2","0","79"
"Weston",2013,"2","83","0","1","0","84"
"Weston",2013,"3","91","3","2","1","97"
"Weston",2013,"4","91","2","1","1","95"
"Weston",2013,"5","72","4","1","0","77"
"Weston",2013,"6","64","3","2","0","69"
"Weston",2013,"7","87","1","3","0","91"
"Weston",2013,"8","102","1","2","0","105"
"Weston",2013,"9","99","2","2","0","103"
"Weston",2013,"10","82","1","4","1","88"
"Weston",2013,"11","72","1","2","1","76"
"Weston",2013,"12","85","0","1","0","86"
"Weston",2013,"13","69","3","0","1","73"
"Weston",2013,"14","75","0","4","0","79"
"Weston",2013,"15","85","2","2","1","90"
"Weston",2013,"16","87","2","4","0","93"
"Weston",2013,"17","70","2","2","0","74"
"Weston",2013,"18 to 20","221","1","8","3","233"
"Weston",2013,"21 to 24","290","5","6","0","301"
"Weston",2013,"25 & over","4936","36","79","27","5078"
"Weston",2013,"Total","6923","73","131","36","7163"
"Hot Springs",1990,"0","55","0","0","0","55"
"Hot Springs",1990,"1","35","0","1","0","36"
"Hot Springs",1990,"2","50","0","6","0","56"
"Hot Springs",1990,"3","51","0","0","0","51"
"Hot Springs",1990,"4","52","0","2","0","54"
"Hot Springs",1990,"5","71","0","2","0","73"
"Hot Springs",1990,"6","62","0","8","0","70"
"Hot Springs",1990,"7","58","0","1","0","59"
"Hot Springs",1990,"8","69","0","4","0","73"
"Hot Springs",1990,"9","84","0","1","0","85"
"Hot Springs",1990,"10","79","0","2","0","81"
"Hot Springs",1990,"11","74","0","3","0","77"
"Hot Springs",1990,"12","78","0","6","0","84"
"Hot Springs",1990,"13","85","0","1","0","86"
"Hot Springs",1990,"14","85","0","4","0","89"
"Hot Springs",1990,"15","74","0","2","0","76"
"Hot Springs",1990,"16","71","0","1","0","72"
"Hot Springs",1990,"17","78","0","1","0","79"
"Hot Springs",1990,"18 to 20","127","1","3","0","131"
"Hot Springs",1990,"21 to 24","114","0","1","0","115"
"Hot Springs",1990,"25 & over","3239","0","45","0","3284"
"Hot Springs",1990,"Total","4691","1","94","0","4786"
"Converse",2016,"0","203","5","5","1","214"
"Converse",2016,"1","209","9","5","2","225"
"Converse",2016,"2","207","8","8","0","223"
"Converse",2016,"3","184","2","7","1","194"
"Converse",2016,"4","204","4","6","0","214"
"Converse",2016,"5","163","3","2","1","169"
"Converse",2016,"6","190","5","2","1","198"
"Converse",2016,"7","210","4","1","2","217"
"Converse",2016,"8","183","4","2","0","189"
"Converse",2016,"9","198","4","4","3","209"
"Converse",2016,"10","204","7","4","0","215"
"Converse",2016,"11","205","4","4","1","214"
"Converse",2016,"12","175","0","3","0","178"
"Converse",2016,"13","160","1","3","2","166"
"Converse",2016,"14","195","1","6","1","203"
"Converse",2016,"15","189","1","0","2","192"
"Converse",2016,"16","208","2","2","4","216"
"Converse",2016,"17","200","4","3","1","208"
"Converse",2016,"18 to 20","403","9","5","0","417"
"Converse",2016,"21 to 24","597","3","7","3","610"
"Converse",2016,"25 & over","9242","88","119","71","9520"
"Converse",2016,"Total","13729","168","198","96","14191"
"Sweetwater",2001,"0","474","11","7","5","497"
"Sweetwater",2001,"1","493","12","10","0","515"
"Sweetwater",2001,"2","500","9","7","1","517"
"Sweetwater",2001,"3","473","11","10","4","498"
"Sweetwater",2001,"4","478","9","6","2","495"
"Sweetwater",2001,"5","453","7","10","5","475"
"Sweetwater",2001,"6","460","5","9","3","477"
"Sweetwater",2001,"7","521","7","15","2","545"
"Sweetwater",2001,"8","497","9","7","7","520"
"Sweetwater",2001,"9","570","8","8","2","588"
"Sweetwater",2001,"10","567","5","10","2","584"
"Sweetwater",2001,"11","564","7","9","2","582"
"Sweetwater",2001,"12","570","7","6","1","584"
"Sweetwater",2001,"13","604","8","10","3","625"
"Sweetwater",2001,"14","660","7","8","2","677"
"Sweetwater",2001,"15","680","12","12","1","705"
"Sweetwater",2001,"16","673","9","7","5","694"
"Sweetwater",2001,"17","703","8","4","6","721"
"Sweetwater",2001,"18 to 20","1909","19","19","25","1972"
"Sweetwater",2001,"21 to 24","1819","18","34","35","1906"
"Sweetwater",2001,"25 & over","22082","181","260","199","22722"
"Sweetwater",2001,"Total","35750","369","468","312","36899"
"Platte",1998,"0","101","0","0","0","101"
"Platte",1998,"1","100","0","1","0","101"
"Platte",1998,"2","86","0","0","0","86"
"Platte",1998,"3","92","0","0","0","92"
"Platte",1998,"4","96","0","1","0","97"
"Platte",1998,"5","124","1","1","1","127"
"Platte",1998,"6","103","0","0","0","103"
"Platte",1998,"7","125","0","0","0","125"
"Platte",1998,"8","134","0","0","0","134"
"Platte",1998,"9","119","0","0","0","119"
"Platte",1998,"10","145","2","0","0","147"
"Platte",1998,"11","138","0","1","0","139"
"Platte",1998,"12","153","0","0","0","153"
"Platte",1998,"13","157","0","0","0","157"
"Platte",1998,"14","141","0","0","0","141"
"Platte",1998,"15","170","0","0","0","170"
"Platte",1998,"16","167","0","0","0","167"
"Platte",1998,"17","162","0","0","0","162"
"Platte",1998,"18 to 20","287","0","0","1","288"
"Platte",1998,"21 to 24","300","0","0","0","300"
"Platte",1998,"25 & over","5917","0","12","1","5930"
"Platte",1998,"Total","8817","3","16","3","8839"
"Big Horn",2005,"0","160","1","4","0","165"
"Big Horn",2005,"1","123","0","3","0","126"
"Big Horn",2005,"2","143","2","0","0","145"
"Big Horn",2005,"3","143","0","2","0","145"
"Big Horn",2005,"4","144","1","1","1","147"
"Big Horn",2005,"5","178","0","1","0","179"
"Big Horn",2005,"6","143","0","0","1","144"
"Big Horn",2005,"7","160","0","0","1","161"
"Big Horn",2005,"8","150","1","1","0","152"
"Big Horn",2005,"9","145","1","1","0","147"
"Big Horn",2005,"10","179","1","4","1","185"
"Big Horn",2005,"11","159","2","1","0","162"
"Big Horn",2005,"12","167","0","1","0","168"
"Big Horn",2005,"13","172","0","1","1","174"
"Big Horn",2005,"14","203","1","4","1","209"
"Big Horn",2005,"15","204","3","1","1","209"
"Big Horn",2005,"16","163","1","1","0","165"
"Big Horn",2005,"17","206","1","3","0","210"
"Big Horn",2005,"18 to 20","352","7","5","1","365"
"Big Horn",2005,"21 to 24","457","4","8","0","469"
"Big Horn",2005,"25 & over","7258","18","69","21","7366"
"Big Horn",2005,"Total","11009","44","111","29","11193"
"Laramie",2008,"0","1172","79","39","15","1305"
"Laramie",2008,"1","1242","64","33","16","1355"
"Laramie",2008,"2","1199","99","31","24","1353"
"Laramie",2008,"3","1181","60","15","28","1284"
"Laramie",2008,"4","1061","68","30","30","1189"
"Laramie",2008,"5","1155","59","16","15","1245"
"Laramie",2008,"6","1137","46","29","23","1235"
"Laramie",2008,"7","1049","47","22","29","1147"
"Laramie",2008,"8","1066","64","12","19","1161"
"Laramie",2008,"9","1063","26","8","18","1115"
"Laramie",2008,"10","1118","52","29","13","1212"
"Laramie",2008,"11","1068","61","36","11","1176"
"Laramie",2008,"12","1022","36","33","9","1100"
"Laramie",2008,"13","1113","46","9","9","1177"
"Laramie",2008,"14","1065","68","11","20","1164"
"Laramie",2008,"15","1162","55","21","32","1270"
"Laramie",2008,"16","1122","49","22","17","1210"
"Laramie",2008,"17","1096","47","21","22","1186"
"Laramie",2008,"18 to 20","3223","181","53","55","3512"
"Laramie",2008,"21 to 24","4949","336","79","110","5474"
"Laramie",2008,"25 & over","55386","1286","666","869","58207"
"Laramie",2008,"Total","83649","2829","1215","1384","89077"
"Platte",2008,"0","89","2","0","1","92"
"Platte",2008,"1","100","0","2","0","102"
"Platte",2008,"2","100","2","2","0","104"
"Platte",2008,"3","75","1","1","2","79"
"Platte",2008,"4","63","2","0","1","66"
"Platte",2008,"5","91","1","0","0","92"
"Platte",2008,"6","109","2","0","0","111"
"Platte",2008,"7","93","2","0","0","95"
"Platte",2008,"8","85","2","0","0","87"
"Platte",2008,"9","97","0","0","0","97"
"Platte",2008,"10","104","0","1","2","107"
"Platte",2008,"11","101","0","0","0","101"
"Platte",2008,"12","112","1","1","0","114"
"Platte",2008,"13","130","1","0","1","132"
"Platte",2008,"14","97","0","1","2","100"
"Platte",2008,"15","117","2","1","0","120"
"Platte",2008,"16","150","0","1","1","152"
"Platte",2008,"17","119","0","3","2","124"
"Platte",2008,"18 to 20","256","1","2","3","262"
"Platte",2008,"21 to 24","289","1","2","2","294"
"Platte",2008,"25 & over","6118","22","30","21","6191"
"Platte",2008,"Total","8495","42","47","38","8622"
"Sublette",2006,"0","84","0","0","0","84"
"Sublette",2006,"1","86","4","2","0","92"
"Sublette",2006,"2","89","0","1","0","90"
"Sublette",2006,"3","97","1","1","0","99"
"Sublette",2006,"4","86","0","2","1","89"
"Sublette",2006,"5","102","0","1","0","103"
"Sublette",2006,"6","84","0","1","1","86"
"Sublette",2006,"7","98","1","1","0","100"
"Sublette",2006,"8","109","0","1","0","110"
"Sublette",2006,"9","100","0","0","0","100"
"Sublette",2006,"10","95","0","1","0","96"
"Sublette",2006,"11","85","0","3","1","89"
"Sublette",2006,"12","101","2","1","0","104"
"Sublette",2006,"13","91","0","2","0","93"
"Sublette",2006,"14","118","0","1","0","119"
"Sublette",2006,"15","101","1","2","2","106"
"Sublette",2006,"16","117","1","2","0","120"
"Sublette",2006,"17","127","0","3","0","130"
"Sublette",2006,"18 to 20","221","2","7","3","233"
"Sublette",2006,"21 to 24","342","2","3","9","356"
"Sublette",2006,"25 & over","5443","40","51","24","5558"
"Sublette",2006,"Total","7776","54","86","41","7957"
"Weston",1999,"0","54","0","2","0","56"
"Weston",1999,"1","73","0","0","0","73"
"Weston",1999,"2","68","0","6","0","74"
"Weston",1999,"3","73","0","2","0","75"
"Weston",1999,"4","75","0","1","0","76"
"Weston",1999,"5","62","0","0","0","62"
"Weston",1999,"6","75","0","0","0","75"
"Weston",1999,"7","72","0","0","0","72"
"Weston",1999,"8","73","0","0","0","73"
"Weston",1999,"9","86","0","5","0","91"
"Weston",1999,"10","90","0","5","0","95"
"Weston",1999,"11","110","0","1","0","111"
"Weston",1999,"12","98","0","0","0","98"
"Weston",1999,"13","119","0","0","0","119"
"Weston",1999,"14","107","0","0","0","107"
"Weston",1999,"15","122","0","0","0","122"
"Weston",1999,"16","121","0","0","0","121"
"Weston",1999,"17","125","0","2","0","127"
"Weston",1999,"18 to 20","264","0","16","0","280"
"Weston",1999,"21 to 24","227","0","6","0","233"
"Weston",1999,"25 & over","4498","0","27","2","4527"
"Weston",1999,"Total","6592","0","73","2","6667"
"Natrona",2001,"0","820","20","30","6","876"
"Natrona",2001,"1","766","23","11","7","807"
"Natrona",2001,"2","862","19","15","7","903"
"Natrona",2001,"3","807","28","19","9","863"
"Natrona",2001,"4","836","22","17","8","883"
"Natrona",2001,"5","855","17","13","5","890"
"Natrona",2001,"6","889","13","13","5","920"
"Natrona",2001,"7","900","15","10","6","931"
"Natrona",2001,"8","854","12","18","2","886"
"Natrona",2001,"9","937","13","13","7","970"
"Natrona",2001,"10","907","12","17","8","944"
"Natrona",2001,"11","1051","17","15","7","1090"
"Natrona",2001,"12","923","14","17","6","960"
"Natrona",2001,"13","952","19","26","9","1006"
"Natrona",2001,"14","975","14","19","6","1014"
"Natrona",2001,"15","1011","12","26","12","1061"
"Natrona",2001,"16","1084","12","16","1","1113"
"Natrona",2001,"17","1016","12","15","6","1049"
"Natrona",2001,"18 to 20","3074","46","45","23","3188"
"Natrona",2001,"21 to 24","3501","44","54","33","3632"
"Natrona",2001,"25 & over","41961","355","456","220","42992"
"Natrona",2001,"Total","64981","739","865","393","66978"
"Sublette",2000,"0","64","1","1","0","66"
"Sublette",2000,"1","66","1","1","0","68"
"Sublette",2000,"2","59","1","0","0","60"
"Sublette",2000,"3","76","1","0","0","77"
"Sublette",2000,"4","75","0","1","1","77"
"Sublette",2000,"5","61","0","0","0","61"
"Sublette",2000,"6","93","0","1","0","94"
"Sublette",2000,"7","79","0","0","0","79"
"Sublette",2000,"8","83","0","1","0","84"
"Sublette",2000,"9","78","1","1","0","80"
"Sublette",2000,"10","88","0","2","0","90"
"Sublette",2000,"11","105","1","2","1","109"
"Sublette",2000,"12","95","0","0","0","95"
"Sublette",2000,"13","97","1","0","0","98"
"Sublette",2000,"14","99","0","0","0","99"
"Sublette",2000,"15","93","0","0","2","95"
"Sublette",2000,"16","102","0","0","0","102"
"Sublette",2000,"17","99","0","0","0","99"
"Sublette",2000,"18 to 20","155","1","0","0","156"
"Sublette",2000,"21 to 24","200","0","2","2","204"
"Sublette",2000,"25 & over","4024","11","21","14","4070"
"Sublette",2000,"Total","5891","19","33","20","5963"
"Teton",2016,"0","226","5","2","2","235"
"Teton",2016,"1","239","3","2","2","246"
"Teton",2016,"2","237","2","1","0","240"
"Teton",2016,"3","234","6","1","2","243"
"Teton",2016,"4","236","3","3","3","245"
"Teton",2016,"5","246","4","0","4","254"
"Teton",2016,"6","267","4","6","3","280"
"Teton",2016,"7","266","4","3","3","276"
"Teton",2016,"8","249","6","3","6","264"
"Teton",2016,"9","272","3","3","1","279"
"Teton",2016,"10","249","2","4","4","259"
"Teton",2016,"11","233","3","1","3","240"
"Teton",2016,"12","221","4","3","4","232"
"Teton",2016,"13","215","2","3","7","227"
"Teton",2016,"14","211","5","1","3","220"
"Teton",2016,"15","195","5","2","5","207"
"Teton",2016,"16","207","2","4","3","216"
"Teton",2016,"17","186","1","2","2","191"
"Teton",2016,"18 to 20","456","5","6","11","478"
"Teton",2016,"21 to 24","824","16","12","19","871"
"Teton",2016,"25 & over","16924","156","169","239","17488"
"Teton",2016,"Total","22393","241","231","326","23191"
"Campbell",1996,"0","457","0","4","3","464"
"Campbell",1996,"1","487","3","8","4","502"
"Campbell",1996,"2","510","2","3","0","515"
"Campbell",1996,"3","473","0","6","0","479"
"Campbell",1996,"4","506","2","8","0","516"
"Campbell",1996,"5","523","0","10","0","533"
"Campbell",1996,"6","571","0","7","1","579"
"Campbell",1996,"7","542","0","9","0","551"
"Campbell",1996,"8","544","4","5","1","554"
"Campbell",1996,"9","592","0","10","8","610"
"Campbell",1996,"10","600","4","8","5","617"
"Campbell",1996,"11","619","0","10","0","629"
"Campbell",1996,"12","655","0","9","5","669"
"Campbell",1996,"13","677","0","16","4","697"
"Campbell",1996,"14","681","0","10","0","691"
"Campbell",1996,"15","695","1","7","4","707"
"Campbell",1996,"16","679","3","9","2","693"
"Campbell",1996,"17","620","1","15","3","639"
"Campbell",1996,"18 to 20","1263","3","13","0","1279"
"Campbell",1996,"21 to 24","1473","3","27","12","1515"
"Campbell",1996,"25 & over","18279","13","164","51","18507"
"Campbell",1996,"Total","31446","39","358","103","31946"
"Sweetwater",2010,"0","634","21","14","7","676"
"Sweetwater",2010,"1","696","20","10","6","732"
"Sweetwater",2010,"2","702","15","14","5","736"
"Sweetwater",2010,"3","702","16","14","4","736"
"Sweetwater",2010,"4","707","15","12","5","739"
"Sweetwater",2010,"5","657","11","12","8","688"
"Sweetwater",2010,"6","649","9","11","7","676"
"Sweetwater",2010,"7","659","13","14","6","692"
"Sweetwater",2010,"8","628","14","8","6","656"
"Sweetwater",2010,"9","623","12","8","9","652"
"Sweetwater",2010,"10","631","10","15","6","662"
"Sweetwater",2010,"11","607","10","10","5","632"
"Sweetwater",2010,"12","585","10","10","4","609"
"Sweetwater",2010,"13","597","11","11","5","624"
"Sweetwater",2010,"14","549","13","11","8","581"
"Sweetwater",2010,"15","540","9","8","3","560"
"Sweetwater",2010,"16","547","9","13","7","576"
"Sweetwater",2010,"17","531","9","15","11","566"
"Sweetwater",2010,"18 to 20","1691","36","31","23","1781"
"Sweetwater",2010,"21 to 24","2332","52","37","39","2460"
"Sweetwater",2010,"25 & over","26677","303","305","270","27555"
"Sweetwater",2010,"Total","41944","618","583","444","43589"
"Converse",1990,"0","180","0","0","0","180"
"Converse",1990,"1","161","2","3","0","166"
"Converse",1990,"2","168","1","0","0","169"
"Converse",1990,"3","174","0","0","0","174"
"Converse",1990,"4","198","0","3","0","201"
"Converse",1990,"5","217","2","2","2","223"
"Converse",1990,"6","194","0","0","0","194"
"Converse",1990,"7","211","1","3","0","215"
"Converse",1990,"8","207","0","0","0","207"
"Converse",1990,"9","245","0","7","2","254"
"Converse",1990,"10","226","0","0","1","227"
"Converse",1990,"11","219","0","2","0","221"
"Converse",1990,"12","214","0","5","0","219"
"Converse",1990,"13","199","0","0","0","199"
"Converse",1990,"14","225","1","3","3","232"
"Converse",1990,"15","195","1","0","1","197"
"Converse",1990,"16","178","0","6","0","184"
"Converse",1990,"17","213","0","2","0","215"
"Converse",1990,"18 to 20","357","0","6","0","363"
"Converse",1990,"21 to 24","371","0","3","0","374"
"Converse",1990,"25 & over","6588","4","48","15","6655"
"Converse",1990,"Total","10940","12","93","24","11069"
"Park",2015,"0","296","9","5","3","313"
"Park",2015,"1","309","10","5","4","328"
"Park",2015,"2","302","6","5","6","319"
"Park",2015,"3","347","4","4","2","357"
"Park",2015,"4","284","8","3","6","301"
"Park",2015,"5","306","3","2","6","317"
"Park",2015,"6","332","4","3","3","342"
"Park",2015,"7","325","4","2","4","335"
"Park",2015,"8","333","4","2","3","342"
"Park",2015,"9","325","5","9","0","339"
"Park",2015,"10","353","0","3","3","359"
"Park",2015,"11","299","4","4","0","307"
"Park",2015,"12","343","2","4","2","351"
"Park",2015,"13","316","1","6","0","323"
"Park",2015,"14","313","1","3","1","318"
"Park",2015,"15","303","2","8","6","319"
"Park",2015,"16","319","2","4","2","327"
"Park",2015,"17","319","5","6","3","333"
"Park",2015,"18 to 20","1038","24","30","30","1122"
"Park",2015,"21 to 24","1173","59","17","17","1266"
"Park",2015,"25 & over","20277","158","148","155","20738"
"Park",2015,"Total","28212","315","273","256","29056"
"Converse",2007,"0","162","1","9","1","173"
"Converse",2007,"1","158","4","1","0","163"
"Converse",2007,"2","173","1","4","0","178"
"Converse",2007,"3","146","5","2","2","155"
"Converse",2007,"4","179","2","4","0","185"
"Converse",2007,"5","187","3","1","1","192"
"Converse",2007,"6","173","1","2","0","176"
"Converse",2007,"7","169","1","4","1","175"
"Converse",2007,"8","169","0","2","0","171"
"Converse",2007,"9","159","2","1","1","163"
"Converse",2007,"10","169","2","1","2","174"
"Converse",2007,"11","199","4","1","0","204"
"Converse",2007,"12","166","4","1","0","171"
"Converse",2007,"13","174","2","2","0","178"
"Converse",2007,"14","193","7","3","1","204"
"Converse",2007,"15","196","2","0","0","198"
"Converse",2007,"16","227","2","9","0","238"
"Converse",2007,"17","217","5","2","1","225"
"Converse",2007,"18 to 20","460","1","3","1","465"
"Converse",2007,"21 to 24","557","2","4","1","564"
"Converse",2007,"25 & over","8589","22","78","30","8719"
"Converse",2007,"Total","12822","73","134","42","13071"
"Hot Springs",1996,"0","46","0","0","0","46"
"Hot Springs",1996,"1","45","0","2","0","47"
"Hot Springs",1996,"2","40","0","5","0","45"
"Hot Springs",1996,"3","42","0","0","0","42"
"Hot Springs",1996,"4","48","0","1","0","49"
"Hot Springs",1996,"5","44","0","1","0","45"
"Hot Springs",1996,"6","51","0","3","0","54"
"Hot Springs",1996,"7","56","0","1","0","57"
"Hot Springs",1996,"8","54","0","3","0","57"
"Hot Springs",1996,"9","72","0","1","0","73"
"Hot Springs",1996,"10","66","0","1","0","67"
"Hot Springs",1996,"11","73","0","2","0","75"
"Hot Springs",1996,"12","79","0","3","0","82"
"Hot Springs",1996,"13","81","0","1","0","82"
"Hot Springs",1996,"14","94","0","3","0","97"
"Hot Springs",1996,"15","77","0","5","0","82"
"Hot Springs",1996,"16","87","0","3","0","90"
"Hot Springs",1996,"17","80","0","2","0","82"
"Hot Springs",1996,"18 to 20","142","1","2","0","145"
"Hot Springs",1996,"21 to 24","123","0","2","0","125"
"Hot Springs",1996,"25 & over","3418","0","37","0","3455"
"Hot Springs",1996,"Total","4818","1","78","0","4897"
"Washakie",2016,"0","90","2","2","1","95"
"Washakie",2016,"1","94","1","2","0","97"
"Washakie",2016,"2","85","4","3","0","92"
"Washakie",2016,"3","83","2","10","0","95"
"Washakie",2016,"4","87","3","4","1","95"
"Washakie",2016,"5","101","6","0","0","107"
"Washakie",2016,"6","99","3","0","0","102"
"Washakie",2016,"7","92","3","1","1","97"
"Washakie",2016,"8","96","2","2","4","104"
"Washakie",2016,"9","105","2","2","3","112"
"Washakie",2016,"10","125","1","3","1","130"
"Washakie",2016,"11","102","0","2","1","105"
"Washakie",2016,"12","115","1","1","2","119"
"Washakie",2016,"13","116","2","2","2","122"
"Washakie",2016,"14","115","0","3","0","118"
"Washakie",2016,"15","115","0","3","0","118"
"Washakie",2016,"16","127","1","1","2","131"
"Washakie",2016,"17","122","2","3","2","129"
"Washakie",2016,"18 to 20","228","3","9","4","244"
"Washakie",2016,"21 to 24","279","7","8","7","301"
"Washakie",2016,"25 & over","5536","51","85","50","5722"
"Washakie",2016,"Total","7912","96","146","81","8235"
"Sheridan",2011,"0","325","5","7","9","346"
"Sheridan",2011,"1","348","4","6","1","359"
"Sheridan",2011,"2","313","2","9","1","325"
"Sheridan",2011,"3","374","3","9","3","389"
"Sheridan",2011,"4","372","6","6","2","386"
"Sheridan",2011,"5","361","4","7","1","373"
"Sheridan",2011,"6","343","5","2","2","352"
"Sheridan",2011,"7","339","3","7","1","350"
"Sheridan",2011,"8","374","4","7","2","387"
"Sheridan",2011,"9","329","1","9","1","340"
"Sheridan",2011,"10","328","4","7","3","342"
"Sheridan",2011,"11","362","3","13","2","380"
"Sheridan",2011,"12","341","4","5","3","353"
"Sheridan",2011,"13","335","3","10","1","349"
"Sheridan",2011,"14","349","6","7","1","363"
"Sheridan",2011,"15","307","5","8","3","323"
"Sheridan",2011,"16","334","7","10","5","356"
"Sheridan",2011,"17","364","3","12","3","382"
"Sheridan",2011,"18 to 20","1045","24","31","15","1115"
"Sheridan",2011,"21 to 24","1176","18","19","15","1228"
"Sheridan",2011,"25 & over","20007","93","228","159","20487"
"Sheridan",2011,"Total","28426","207","419","233","29285"
"Platte",2002,"0","91","0","1","0","92"
"Platte",2002,"1","91","0","1","0","92"
"Platte",2002,"2","111","0","0","1","112"
"Platte",2002,"3","93","1","1","1","96"
"Platte",2002,"4","89","1","0","0","90"
"Platte",2002,"5","100","2","0","1","103"
"Platte",2002,"6","97","0","1","0","98"
"Platte",2002,"7","110","1","0","1","112"
"Platte",2002,"8","106","0","0","0","106"
"Platte",2002,"9","107","2","0","0","109"
"Platte",2002,"10","135","0","2","1","138"
"Platte",2002,"11","123","2","1","1","127"
"Platte",2002,"12","167","1","2","0","170"
"Platte",2002,"13","139","0","0","0","139"
"Platte",2002,"14","135","0","1","2","138"
"Platte",2002,"15","149","2","1","0","152"
"Platte",2002,"16","151","0","1","0","152"
"Platte",2002,"17","150","0","3","0","153"
"Platte",2002,"18 to 20","304","2","4","2","312"
"Platte",2002,"21 to 24","260","0","4","1","265"
"Platte",2002,"25 & over","5961","5","32","12","6010"
"Platte",2002,"Total","8669","19","55","23","8766"
"Laramie",1995,"0","1052","50","10","15","1127"
"Laramie",1995,"1","1039","41","6","20","1106"
"Laramie",1995,"2","1017","46","13","23","1099"
"Laramie",1995,"3","1035","51","9","20","1115"
"Laramie",1995,"4","1002","34","29","14","1079"
"Laramie",1995,"5","1096","65","11","14","1186"
"Laramie",1995,"6","1046","49","17","14","1126"
"Laramie",1995,"7","1080","51","9","19","1159"
"Laramie",1995,"8","1071","56","9","12","1148"
"Laramie",1995,"9","1130","59","14","13","1216"
"Laramie",1995,"10","1173","39","21","26","1259"
"Laramie",1995,"11","1161","61","12","14","1248"
"Laramie",1995,"12","1201","39","18","12","1270"
"Laramie",1995,"13","1230","30","12","16","1288"
"Laramie",1995,"14","1197","40","25","15","1277"
"Laramie",1995,"15","1240","67","7","18","1332"
"Laramie",1995,"16","1152","30","10","11","1203"
"Laramie",1995,"17","1121","29","9","16","1175"
"Laramie",1995,"18 to 20","3106","154","40","48","3348"
"Laramie",1995,"21 to 24","4316","202","60","95","4673"
"Laramie",1995,"25 & over","47953","1233","368","525","50079"
"Laramie",1995,"Total","75418","2426","709","960","79513"
"Sweetwater",2002,"0","540","10","20","2","572"
"Sweetwater",2002,"1","512","15","13","2","542"
"Sweetwater",2002,"2","504","9","10","1","524"
"Sweetwater",2002,"3","510","9","11","5","535"
"Sweetwater",2002,"4","491","9","11","1","512"
"Sweetwater",2002,"5","489","9","12","3","513"
"Sweetwater",2002,"6","459","4","9","2","474"
"Sweetwater",2002,"7","452","6","10","4","472"
"Sweetwater",2002,"8","524","8","6","2","540"
"Sweetwater",2002,"9","510","11","9","5","535"
"Sweetwater",2002,"10","582","8","9","1","600"
"Sweetwater",2002,"11","595","6","14","2","617"
"Sweetwater",2002,"12","552","6","8","1","567"
"Sweetwater",2002,"13","574","8","10","2","594"
"Sweetwater",2002,"14","602","10","8","3","623"
"Sweetwater",2002,"15","661","10","6","2","679"
"Sweetwater",2002,"16","666","8","7","5","686"
"Sweetwater",2002,"17","651","7","8","5","671"
"Sweetwater",2002,"18 to 20","1890","19","22","26","1957"
"Sweetwater",2002,"21 to 24","2013","24","34","35","2106"
"Sweetwater",2002,"25 & over","22439","200","260","210","23109"
"Sweetwater",2002,"Total","36216","396","497","319","37428"
"Washakie",2008,"0","108","2","0","0","110"
"Washakie",2008,"1","98","3","2","2","105"
"Washakie",2008,"2","109","0","0","1","110"
"Washakie",2008,"3","118","0","3","1","122"
"Washakie",2008,"4","103","0","5","0","108"
"Washakie",2008,"5","117","0","1","1","119"
"Washakie",2008,"6","107","0","2","1","110"
"Washakie",2008,"7","110","0","3","1","114"
"Washakie",2008,"8","111","0","0","0","111"
"Washakie",2008,"9","90","2","1","0","93"
"Washakie",2008,"10","121","2","1","1","125"
"Washakie",2008,"11","95","1","3","1","100"
"Washakie",2008,"12","90","0","6","0","96"
"Washakie",2008,"13","110","0","1","2","113"
"Washakie",2008,"14","96","0","5","0","101"
"Washakie",2008,"15","111","2","3","3","119"
"Washakie",2008,"16","147","2","1","1","151"
"Washakie",2008,"17","118","3","5","2","128"
"Washakie",2008,"18 to 20","248","2","6","3","259"
"Washakie",2008,"21 to 24","283","6","1","9","299"
"Washakie",2008,"25 & over","5492","28","76","40","5636"
"Washakie",2008,"Total","7982","53","125","69","8229"
"Laramie",1993,"0","1084","47","16","19","1166"
"Laramie",1993,"1","1058","40","10","21","1129"
"Laramie",1993,"2","1055","34","15","16","1120"
"Laramie",1993,"3","1106","65","9","16","1196"
"Laramie",1993,"4","1031","60","19","16","1126"
"Laramie",1993,"5","1060","62","12","14","1148"
"Laramie",1993,"6","1065","57","15","12","1149"
"Laramie",1993,"7","1119","43","9","18","1189"
"Laramie",1993,"8","1113","40","12","16","1181"
"Laramie",1993,"9","1143","70","13","13","1239"
"Laramie",1993,"10","1198","43","15","25","1281"
"Laramie",1993,"11","1192","44","15","17","1268"
"Laramie",1993,"12","1174","44","19","10","1247"
"Laramie",1993,"13","1205","47","12","16","1280"
"Laramie",1993,"14","1111","34","22","15","1182"
"Laramie",1993,"15","1141","41","6","13","1201"
"Laramie",1993,"16","1096","34","8","11","1149"
"Laramie",1993,"17","1057","33","8","25","1123"
"Laramie",1993,"18 to 20","3064","142","44","42","3292"
"Laramie",1993,"21 to 24","4207","216","46","90","4559"
"Laramie",1993,"25 & over","46239","1157","359","515","48270"
"Laramie",1993,"Total","73518","2353","684","940","77495"
"Platte",2001,"0","89","0","1","0","90"
"Platte",2001,"1","106","0","1","0","107"
"Platte",2001,"2","93","0","0","2","95"
"Platte",2001,"3","82","1","2","1","86"
"Platte",2001,"4","95","0","0","0","95"
"Platte",2001,"5","83","2","0","1","86"
"Platte",2001,"6","108","0","1","0","109"
"Platte",2001,"7","99","1","0","1","101"
"Platte",2001,"8","115","0","0","0","115"
"Platte",2001,"9","130","2","0","1","133"
"Platte",2001,"10","122","0","2","1","125"
"Platte",2001,"11","160","2","1","1","164"
"Platte",2001,"12","131","1","2","0","134"
"Platte",2001,"13","147","0","0","0","147"
"Platte",2001,"14","140","0","1","1","142"
"Platte",2001,"15","145","2","1","0","148"
"Platte",2001,"16","158","0","1","1","160"
"Platte",2001,"17","140","0","3","0","143"
"Platte",2001,"18 to 20","293","3","4","2","302"
"Platte",2001,"21 to 24","251","0","4","0","255"
"Platte",2001,"25 & over","5983","4","31","10","6028"
"Platte",2001,"Total","8670","18","55","22","8765"
"Sublette",1991,"0","65","0","0","0","65"
"Sublette",1991,"1","75","0","3","3","81"
"Sublette",1991,"2","73","0","0","0","73"
"Sublette",1991,"3","70","0","0","0","70"
"Sublette",1991,"4","75","0","0","0","75"
"Sublette",1991,"5","66","0","3","0","69"
"Sublette",1991,"6","68","0","0","0","68"
"Sublette",1991,"7","82","0","0","0","82"
"Sublette",1991,"8","75","0","3","0","78"
"Sublette",1991,"9","79","0","0","0","79"
"Sublette",1991,"10","76","0","7","0","83"
"Sublette",1991,"11","99","0","0","0","99"
"Sublette",1991,"12","79","0","0","0","79"
"Sublette",1991,"13","83","0","0","0","83"
"Sublette",1991,"14","73","0","0","0","73"
"Sublette",1991,"15","80","0","0","0","80"
"Sublette",1991,"16","77","0","0","0","77"
"Sublette",1991,"17","71","0","0","0","71"
"Sublette",1991,"18 to 20","142","0","0","0","142"
"Sublette",1991,"21 to 24","158","0","5","0","163"
"Sublette",1991,"25 & over","3243","2","27","2","3274"
"Sublette",1991,"Total","4909","2","48","5","4964"
"Teton",1990,"0","188","0","2","1","191"
"Teton",1990,"1","188","2","0","2","192"
"Teton",1990,"2","165","0","4","0","169"
"Teton",1990,"3","176","0","0","1","177"
"Teton",1990,"4","178","0","3","0","181"
"Teton",1990,"5","161","0","2","0","163"
"Teton",1990,"6","150","0","0","0","150"
"Teton",1990,"7","159","2","3","0","164"
"Teton",1990,"8","160","0","0","3","163"
"Teton",1990,"9","158","1","0","0","159"
"Teton",1990,"10","159","1","4","0","164"
"Teton",1990,"11","130","0","0","0","130"
"Teton",1990,"12","130","0","0","0","130"
"Teton",1990,"13","151","0","0","0","151"
"Teton",1990,"14","132","0","6","2","140"
"Teton",1990,"15","115","1","2","2","120"
"Teton",1990,"16","115","0","3","0","118"
"Teton",1990,"17","117","0","0","0","117"
"Teton",1990,"18 to 20","310","1","8","0","319"
"Teton",1990,"21 to 24","568","2","7","5","582"
"Teton",1990,"25 & over","7559","5","54","30","7648"
"Teton",1990,"Total","11169","15","98","46","11328"
"Sweetwater",2009,"0","728","20","21","8","777"
"Sweetwater",2009,"1","699","11","26","7","743"
"Sweetwater",2009,"2","717","18","18","5","758"
"Sweetwater",2009,"3","732","21","7","3","763"
"Sweetwater",2009,"4","659","16","14","11","700"
"Sweetwater",2009,"5","628","12","12","4","656"
"Sweetwater",2009,"6","742","10","6","6","764"
"Sweetwater",2009,"7","635","16","17","10","678"
"Sweetwater",2009,"8","615","14","4","7","640"
"Sweetwater",2009,"9","629","13","5","4","651"
"Sweetwater",2009,"10","627","12","14","7","660"
"Sweetwater",2009,"11","640","15","12","3","670"
"Sweetwater",2009,"12","599","14","7","7","627"
"Sweetwater",2009,"13","548","10","8","3","569"
"Sweetwater",2009,"14","558","15","9","9","591"
"Sweetwater",2009,"15","555","10","8","4","577"
"Sweetwater",2009,"16","554","10","11","9","584"
"Sweetwater",2009,"17","575","9","12","8","604"
"Sweetwater",2009,"18 to 20","1784","39","40","21","1884"
"Sweetwater",2009,"21 to 24","2565","55","38","39","2697"
"Sweetwater",2009,"25 & over","26608","344","313","275","27540"
"Sweetwater",2009,"Total","42397","684","602","450","44133"
"Park",2009,"0","307","4","4","3","318"
"Park",2009,"1","314","3","3","0","320"
"Park",2009,"2","331","1","1","3","336"
"Park",2009,"3","323","2","2","1","328"
"Park",2009,"4","300","0","5","1","306"
"Park",2009,"5","298","1","3","2","304"
"Park",2009,"6","355","6","2","1","364"
"Park",2009,"7","289","2","4","2","297"
"Park",2009,"8","284","2","4","1","291"
"Park",2009,"9","305","3","2","2","312"
"Park",2009,"10","296","2","6","1","305"
"Park",2009,"11","333","2","5","2","342"
"Park",2009,"12","305","5","11","7","328"
"Park",2009,"13","347","6","5","4","362"
"Park",2009,"14","299","2","2","4","307"
"Park",2009,"15","347","1","3","2","353"
"Park",2009,"16","334","1","5","0","340"
"Park",2009,"17","380","5","2","0","387"
"Park",2009,"18 to 20","1263","18","22","29","1332"
"Park",2009,"21 to 24","1204","9","8","22","1243"
"Park",2009,"25 & over","19268","34","123","108","19533"
"Park",2009,"Total","27482","109","222","195","28008"
"Sheridan",2005,"0","309","4","7","1","321"
"Sheridan",2005,"1","282","1","10","1","294"
"Sheridan",2005,"2","345","2","10","2","359"
"Sheridan",2005,"3","268","2","6","3","279"
"Sheridan",2005,"4","288","1","5","1","295"
"Sheridan",2005,"5","322","2","6","2","332"
"Sheridan",2005,"6","255","3","5","0","263"
"Sheridan",2005,"7","290","3","5","1","299"
"Sheridan",2005,"8","286","0","4","3","293"
"Sheridan",2005,"9","252","3","7","1","263"
"Sheridan",2005,"10","301","4","7","2","314"
"Sheridan",2005,"11","322","2","6","1","331"
"Sheridan",2005,"12","368","3","8","1","380"
"Sheridan",2005,"13","319","5","9","2","335"
"Sheridan",2005,"14","328","0","12","7","347"
"Sheridan",2005,"15","400","4","10","2","416"
"Sheridan",2005,"16","393","3","14","4","414"
"Sheridan",2005,"17","402","3","11","1","417"
"Sheridan",2005,"18 to 20","1052","13","25","10","1100"
"Sheridan",2005,"21 to 24","1205","12","23","14","1254"
"Sheridan",2005,"25 & over","18394","53","206","116","18769"
"Sheridan",2005,"Total","26381","123","396","175","27075"
"Sheridan",1997,"0","283","0","1","0","284"
"Sheridan",1997,"1","254","1","7","3","265"
"Sheridan",1997,"2","278","0","0","0","278"
"Sheridan",1997,"3","292","0","2","0","294"
"Sheridan",1997,"4","262","0","7","2","271"
"Sheridan",1997,"5","292","1","8","2","303"
"Sheridan",1997,"6","327","0","7","4","338"
"Sheridan",1997,"7","365","0","2","0","367"
"Sheridan",1997,"8","315","0","10","0","325"
"Sheridan",1997,"9","330","0","4","0","334"
"Sheridan",1997,"10","365","0","5","1","371"
"Sheridan",1997,"11","377","0","2","1","380"
"Sheridan",1997,"12","415","3","6","0","424"
"Sheridan",1997,"13","396","2","3","0","401"
"Sheridan",1997,"14","441","0","16","8","465"
"Sheridan",1997,"15","486","1","16","1","504"
"Sheridan",1997,"16","459","0","7","3","469"
"Sheridan",1997,"17","481","0","4","10","495"
"Sheridan",1997,"18 to 20","1040","13","14","0","1067"
"Sheridan",1997,"21 to 24","938","0","17","11","966"
"Sheridan",1997,"25 & over","17266","10","162","56","17494"
"Sheridan",1997,"Total","25662","31","300","102","26095"
"Niobrara",1991,"0","29","0","0","0","29"
"Niobrara",1991,"1","25","0","0","0","25"
"Niobrara",1991,"2","29","0","0","0","29"
"Niobrara",1991,"3","29","0","0","0","29"
"Niobrara",1991,"4","23","0","0","0","23"
"Niobrara",1991,"5","32","0","0","0","32"
"Niobrara",1991,"6","30","0","0","0","30"
"Niobrara",1991,"7","40","0","0","0","40"
"Niobrara",1991,"8","36","0","0","0","36"
"Niobrara",1991,"9","35","0","0","0","35"
"Niobrara",1991,"10","33","0","0","0","33"
"Niobrara",1991,"11","40","0","0","0","40"
"Niobrara",1991,"12","32","0","0","0","32"
"Niobrara",1991,"13","38","0","0","0","38"
"Niobrara",1991,"14","38","0","0","0","38"
"Niobrara",1991,"15","38","0","0","0","38"
"Niobrara",1991,"16","37","0","0","0","37"
"Niobrara",1991,"17","33","0","0","0","33"
"Niobrara",1991,"18 to 20","63","2","0","0","65"
"Niobrara",1991,"21 to 24","57","0","0","0","57"
"Niobrara",1991,"25 & over","1672","2","3","0","1677"
"Niobrara",1991,"Total","2389","4","3","0","2396"
"Platte",2000,"0","98","0","1","0","99"
"Platte",2000,"1","92","0","1","0","93"
"Platte",2000,"2","78","0","0","1","79"
"Platte",2000,"3","88","1","1","1","91"
"Platte",2000,"4","85","0","1","0","86"
"Platte",2000,"5","116","2","0","1","119"
"Platte",2000,"6","95","0","2","0","97"
"Platte",2000,"7","124","1","0","1","126"
"Platte",2000,"8","124","0","0","0","124"
"Platte",2000,"9","112","2","0","1","115"
"Platte",2000,"10","151","0","2","1","154"
"Platte",2000,"11","125","2","1","1","129"
"Platte",2000,"12","141","1","2","0","144"
"Platte",2000,"13","143","0","0","0","143"
"Platte",2000,"14","129","0","1","1","131"
"Platte",2000,"15","156","3","1","0","160"
"Platte",2000,"16","156","1","1","1","159"
"Platte",2000,"17","155","0","3","0","158"
"Platte",2000,"18 to 20","289","3","4","2","298"
"Platte",2000,"21 to 24","271","0","4","0","275"
"Platte",2000,"25 & over","5913","3","33","10","5959"
"Platte",2000,"Total","8641","19","58","21","8739"
"Teton",2006,"0","293","3","3","1","300"
"Teton",2006,"1","254","3","3","1","261"
"Teton",2006,"2","198","2","2","3","205"
"Teton",2006,"3","200","1","0","2","203"
"Teton",2006,"4","150","3","2","2","157"
"Teton",2006,"5","178","1","2","3","184"
"Teton",2006,"6","172","3","0","3","178"
"Teton",2006,"7","177","2","2","5","186"
"Teton",2006,"8","168","2","3","3","176"
"Teton",2006,"9","183","0","1","1","185"
"Teton",2006,"10","192","2","3","4","201"
"Teton",2006,"11","192","1","1","1","195"
"Teton",2006,"12","218","2","1","3","224"
"Teton",2006,"13","189","1","1","2","193"
"Teton",2006,"14","230","0","1","4","235"
"Teton",2006,"15","238","1","1","6","246"
"Teton",2006,"16","246","0","2","2","250"
"Teton",2006,"17","242","1","4","4","251"
"Teton",2006,"18 to 20","507","4","5","6","522"
"Teton",2006,"21 to 24","1175","4","15","16","1210"
"Teton",2006,"25 & over","14141","39","113","159","14452"
"Teton",2006,"Total","19543","75","165","231","20014"
"Albany",2006,"0","383","8","6","8","405"
"Albany",2006,"1","321","10","4","18","353"
"Albany",2006,"2","302","13","5","5","325"
"Albany",2006,"3","330","11","5","8","354"
"Albany",2006,"4","278","9","8","12","307"
"Albany",2006,"5","300","7","9","9","325"
"Albany",2006,"6","254","9","5","7","275"
"Albany",2006,"7","237","7","5","10","259"
"Albany",2006,"8","281","11","7","6","305"
"Albany",2006,"9","279","4","3","16","302"
"Albany",2006,"10","269","8","7","4","288"
"Albany",2006,"11","260","7","3","8","278"
"Albany",2006,"12","254","6","3","2","265"
"Albany",2006,"13","294","6","3","9","312"
"Albany",2006,"14","258","5","6","4","273"
"Albany",2006,"15","290","6","3","5","304"
"Albany",2006,"16","317","5","7","2","331"
"Albany",2006,"17","273","11","5","4","293"
"Albany",2006,"18 to 20","4404","76","40","87","4607"
"Albany",2006,"21 to 24","5937","94","60","197","6288"
"Albany",2006,"25 & over","16640","202","177","482","17501"
"Albany",2006,"Total","32161","515","371","903","33950"
"Sublette",2013,"0","133","0","0","0","133"
"Sublette",2013,"1","140","1","0","0","141"
"Sublette",2013,"2","147","1","1","0","149"
"Sublette",2013,"3","111","1","0","1","113"
"Sublette",2013,"4","139","4","1","1","145"
"Sublette",2013,"5","150","2","2","1","155"
"Sublette",2013,"6","133","1","2","0","136"
"Sublette",2013,"7","124","0","1","2","127"
"Sublette",2013,"8","117","1","2","2","122"
"Sublette",2013,"9","131","2","3","2","138"
"Sublette",2013,"10","136","2","1","0","139"
"Sublette",2013,"11","131","1","2","15","149"
"Sublette",2013,"12","117","0","2","16","135"
"Sublette",2013,"13","131","3","2","3","139"
"Sublette",2013,"14","137","1","1","1","140"
"Sublette",2013,"15","115","2","2","3","122"
"Sublette",2013,"16","123","1","1","0","125"
"Sublette",2013,"17","124","0","4","0","128"
"Sublette",2013,"18 to 20","291","11","9","3","314"
"Sublette",2013,"21 to 24","385","7","5","8","405"
"Sublette",2013,"25 & over","6689","111","68","59","6927"
"Sublette",2013,"Total","9704","152","109","117","10082"
"Converse",1993,"0","157","0","0","0","157"
"Converse",1993,"1","147","2","4","0","153"
"Converse",1993,"2","156","2","0","0","158"
"Converse",1993,"3","172","0","0","0","172"
"Converse",1993,"4","179","0","3","0","182"
"Converse",1993,"5","188","2","3","2","195"
"Converse",1993,"6","170","0","0","0","170"
"Converse",1993,"7","196","1","4","0","201"
"Converse",1993,"8","202","0","0","0","202"
"Converse",1993,"9","229","0","5","1","235"
"Converse",1993,"10","220","0","0","1","221"
"Converse",1993,"11","225","0","2","0","227"
"Converse",1993,"12","229","0","6","0","235"
"Converse",1993,"13","233","0","0","0","233"
"Converse",1993,"14","247","2","5","2","256"
"Converse",1993,"15","213","1","0","1","215"
"Converse",1993,"16","200","0","4","0","204"
"Converse",1993,"17","228","0","2","0","230"
"Converse",1993,"18 to 20","367","0","6","0","373"
"Converse",1993,"21 to 24","409","0","4","0","413"
"Converse",1993,"25 & over","6936","3","51","14","7004"
"Converse",1993,"Total","11303","13","99","21","11436"
"Albany",2007,"0","373","7","6","9","395"
"Albany",2007,"1","346","15","4","8","373"
"Albany",2007,"2","321","11","6","11","349"
"Albany",2007,"3","302","13","7","5","327"
"Albany",2007,"4","287","10","6","13","316"
"Albany",2007,"5","278","4","5","12","299"
"Albany",2007,"6","268","9","4","7","288"
"Albany",2007,"7","264","6","5","10","285"
"Albany",2007,"8","224","7","6","10","247"
"Albany",2007,"9","285","7","2","9","303"
"Albany",2007,"10","268","10","6","5","289"
"Albany",2007,"11","247","7","4","6","264"
"Albany",2007,"12","247","18","2","6","273"
"Albany",2007,"13","261","5","3","4","273"
"Albany",2007,"14","278","5","6","9","298"
"Albany",2007,"15","295","5","5","4","309"
"Albany",2007,"16","281","7","6","11","305"
"Albany",2007,"17","305","12","7","4","328"
"Albany",2007,"18 to 20","4293","75","39","83","4490"
"Albany",2007,"21 to 24","5733","98","58","196","6085"
"Albany",2007,"25 & over","16884","204","185","489","17762"
"Albany",2007,"Total","32040","535","372","911","33858"
"Hot Springs",2006,"0","44","0","1","0","45"
"Hot Springs",2006,"1","47","2","2","0","51"
"Hot Springs",2006,"2","32","3","3","0","38"
"Hot Springs",2006,"3","37","1","1","0","39"
"Hot Springs",2006,"4","49","1","0","0","50"
"Hot Springs",2006,"5","43","0","2","0","45"
"Hot Springs",2006,"6","50","0","0","0","50"
"Hot Springs",2006,"7","59","1","0","1","61"
"Hot Springs",2006,"8","49","1","1","0","51"
"Hot Springs",2006,"9","41","1","2","0","44"
"Hot Springs",2006,"10","61","0","1","0","62"
"Hot Springs",2006,"11","44","1","2","0","47"
"Hot Springs",2006,"12","52","0","0","0","52"
"Hot Springs",2006,"13","48","1","2","0","51"
"Hot Springs",2006,"14","48","1","0","1","50"
"Hot Springs",2006,"15","57","0","1","1","59"
"Hot Springs",2006,"16","44","1","2","0","47"
"Hot Springs",2006,"17","58","1","1","0","60"
"Hot Springs",2006,"18 to 20","154","0","4","1","159"
"Hot Springs",2006,"21 to 24","180","2","9","2","193"
"Hot Springs",2006,"25 & over","3318","7","40","13","3378"
"Hot Springs",2006,"Total","4515","24","74","19","4632"
"Crook",1996,"0","71","0","0","0","71"
"Crook",1996,"1","68","0","2","0","70"
"Crook",1996,"2","67","0","0","0","67"
"Crook",1996,"3","63","0","0","0","63"
"Crook",1996,"4","74","0","0","0","74"
"Crook",1996,"5","75","0","2","0","77"
"Crook",1996,"6","91","0","0","0","91"
"Crook",1996,"7","90","0","0","0","90"
"Crook",1996,"8","86","0","0","0","86"
"Crook",1996,"9","90","0","0","0","90"
"Crook",1996,"10","100","0","5","0","105"
"Crook",1996,"11","113","0","0","0","113"
"Crook",1996,"12","106","0","0","0","106"
"Crook",1996,"13","121","0","0","0","121"
"Crook",1996,"14","114","0","0","0","114"
"Crook",1996,"15","111","0","5","0","116"
"Crook",1996,"16","116","0","0","0","116"
"Crook",1996,"17","115","0","0","0","115"
"Crook",1996,"18 to 20","203","0","3","0","206"
"Crook",1996,"21 to 24","189","0","0","0","189"
"Crook",1996,"25 & over","3718","0","15","0","3733"
"Crook",1996,"Total","5781","0","32","0","5813"
"Crook",1994,"0","76","0","0","0","76"
"Crook",1994,"1","71","0","2","0","73"
"Crook",1994,"2","75","0","0","0","75"
"Crook",1994,"3","67","0","0","0","67"
"Crook",1994,"4","82","0","0","0","82"
"Crook",1994,"5","76","0","2","0","78"
"Crook",1994,"6","90","0","0","0","90"
"Crook",1994,"7","91","0","0","0","91"
"Crook",1994,"8","94","0","0","0","94"
"Crook",1994,"9","102","0","0","0","102"
"Crook",1994,"10","104","0","6","0","110"
"Crook",1994,"11","115","0","0","0","115"
"Crook",1994,"12","115","0","0","0","115"
"Crook",1994,"13","115","0","0","0","115"
"Crook",1994,"14","112","0","0","0","112"
"Crook",1994,"15","105","0","4","0","109"
"Crook",1994,"16","101","0","0","0","101"
"Crook",1994,"17","98","0","0","0","98"
"Crook",1994,"18 to 20","181","0","2","0","183"
"Crook",1994,"21 to 24","189","0","0","0","189"
"Crook",1994,"25 & over","3567","0","15","0","3582"
"Crook",1994,"Total","5626","0","31","0","5657"
"Uinta",1994,"0","332","0","1","0","333"
"Uinta",1994,"1","361","3","5","2","371"
"Uinta",1994,"2","335","0","3","0","338"
"Uinta",1994,"3","336","0","0","3","339"
"Uinta",1994,"4","384","3","3","2","392"
"Uinta",1994,"5","365","4","2","2","373"
"Uinta",1994,"6","405","2","1","2","410"
"Uinta",1994,"7","384","0","6","3","393"
"Uinta",1994,"8","404","2","1","0","407"
"Uinta",1994,"9","433","0","2","4","439"
"Uinta",1994,"10","461","4","4","6","475"
"Uinta",1994,"11","459","0","4","0","463"
"Uinta",1994,"12","485","0","5","0","490"
"Uinta",1994,"13","473","0","4","2","479"
"Uinta",1994,"14","482","0","5","0","487"
"Uinta",1994,"15","448","1","7","0","456"
"Uinta",1994,"16","454","0","4","2","460"
"Uinta",1994,"17","415","0","2","1","418"
"Uinta",1994,"18 to 20","760","0","4","6","770"
"Uinta",1994,"21 to 24","821","0","12","0","833"
"Uinta",1994,"25 & over","10705","5","63","28","10801"
"Uinta",1994,"Total","19702","24","138","63","19927"
"Fremont",2000,"0","298","1","178","1","478"
"Fremont",2000,"1","302","1","187","0","490"
"Fremont",2000,"2","311","3","149","1","464"
"Fremont",2000,"3","295","2","146","1","444"
"Fremont",2000,"4","289","3","164","1","457"
"Fremont",2000,"5","311","3","150","0","464"
"Fremont",2000,"6","346","2","160","2","510"
"Fremont",2000,"7","325","1","167","1","494"
"Fremont",2000,"8","364","3","177","1","545"
"Fremont",2000,"9","387","2","184","2","575"
"Fremont",2000,"10","357","1","152","1","511"
"Fremont",2000,"11","397","2","202","4","605"
"Fremont",2000,"12","391","3","167","2","563"
"Fremont",2000,"13","446","1","183","2","632"
"Fremont",2000,"14","505","0","173","2","680"
"Fremont",2000,"15","464","1","158","1","624"
"Fremont",2000,"16","474","3","158","1","636"
"Fremont",2000,"17","480","1","156","0","637"
"Fremont",2000,"18 to 20","1145","6","445","4","1600"
"Fremont",2000,"21 to 24","970","3","386","15","1374"
"Fremont",2000,"25 & over","19417","35","3521","84","23057"
"Fremont",2000,"Total","28274","77","7363","126","35840"
"Big Horn",1999,"0","160","0","0","0","160"
"Big Horn",1999,"1","151","0","2","0","153"
"Big Horn",1999,"2","169","0","0","0","169"
"Big Horn",1999,"3","146","0","0","0","146"
"Big Horn",1999,"4","158","0","4","0","162"
"Big Horn",1999,"5","174","0","5","2","181"
"Big Horn",1999,"6","169","0","0","0","169"
"Big Horn",1999,"7","163","0","0","0","163"
"Big Horn",1999,"8","181","0","0","0","181"
"Big Horn",1999,"9","213","0","0","0","213"
"Big Horn",1999,"10","182","0","7","2","191"
"Big Horn",1999,"11","176","0","1","0","177"
"Big Horn",1999,"12","221","0","4","0","225"
"Big Horn",1999,"13","205","0","0","0","205"
"Big Horn",1999,"14","200","0","0","2","202"
"Big Horn",1999,"15","183","0","6","0","189"
"Big Horn",1999,"16","236","0","0","0","236"
"Big Horn",1999,"17","215","0","2","2","219"
"Big Horn",1999,"18 to 20","428","0","7","0","435"
"Big Horn",1999,"21 to 24","395","0","0","0","395"
"Big Horn",1999,"25 & over","7264","0","36","9","7309"
"Big Horn",1999,"Total","11389","0","74","17","11480"
"Natrona",1994,"0","863","10","9","3","885"
"Natrona",1994,"1","877","10","9","6","902"
"Natrona",1994,"2","841","12","14","1","868"
"Natrona",1994,"3","889","10","20","8","927"
"Natrona",1994,"4","951","19","11","3","984"
"Natrona",1994,"5","927","11","10","5","953"
"Natrona",1994,"6","930","16","10","1","957"
"Natrona",1994,"7","972","20","7","7","1006"
"Natrona",1994,"8","998","11","10","4","1023"
"Natrona",1994,"9","1047","12","14","12","1085"
"Natrona",1994,"10","1107","21","9","7","1144"
"Natrona",1994,"11","1110","11","8","6","1135"
"Natrona",1994,"12","1095","13","12","5","1125"
"Natrona",1994,"13","1077","10","16","9","1112"
"Natrona",1994,"14","1073","16","14","5","1108"
"Natrona",1994,"15","1076","11","15","8","1110"
"Natrona",1994,"16","982","6","4","2","994"
"Natrona",1994,"17","1030","14","8","3","1055"
"Natrona",1994,"18 to 20","2901","51","26","17","2995"
"Natrona",1994,"21 to 24","3068","22","38","17","3145"
"Natrona",1994,"25 & over","40067","241","326","169","40803"
"Natrona",1994,"Total","63881","547","590","298","65316"
"Washakie",1995,"0","99","0","0","1","100"
"Washakie",1995,"1","103","0","2","0","105"
"Washakie",1995,"2","106","0","0","1","107"
"Washakie",1995,"3","99","0","0","0","99"
"Washakie",1995,"4","102","0","0","0","102"
"Washakie",1995,"5","114","1","4","1","120"
"Washakie",1995,"6","106","0","0","2","108"
"Washakie",1995,"7","117","0","0","0","117"
"Washakie",1995,"8","140","0","0","0","140"
"Washakie",1995,"9","149","0","0","0","149"
"Washakie",1995,"10","164","0","0","1","165"
"Washakie",1995,"11","157","0","0","0","157"
"Washakie",1995,"12","152","0","2","2","156"
"Washakie",1995,"13","156","0","2","0","158"
"Washakie",1995,"14","170","0","1","0","171"
"Washakie",1995,"15","181","0","5","0","186"
"Washakie",1995,"16","172","0","0","0","172"
"Washakie",1995,"17","149","0","0","1","150"
"Washakie",1995,"18 to 20","271","1","1","0","273"
"Washakie",1995,"21 to 24","283","0","0","0","283"
"Washakie",1995,"25 & over","5454","1","20","18","5493"
"Washakie",1995,"Total","8444","3","37","27","8511"
"Carbon",1991,"0","186","0","0","1","187"
"Carbon",1991,"1","223","0","3","1","227"
"Carbon",1991,"2","216","3","0","0","219"
"Carbon",1991,"3","210","0","4","0","214"
"Carbon",1991,"4","242","0","0","0","242"
"Carbon",1991,"5","269","2","7","0","278"
"Carbon",1991,"6","276","1","1","0","278"
"Carbon",1991,"7","271","1","0","2","274"
"Carbon",1991,"8","258","3","7","2","270"
"Carbon",1991,"9","279","1","0","3","283"
"Carbon",1991,"10","304","4","4","2","314"
"Carbon",1991,"11","312","3","5","0","320"
"Carbon",1991,"12","304","3","0","2","309"
"Carbon",1991,"13","279","0","0","0","279"
"Carbon",1991,"14","295","0","0","1","296"
"Carbon",1991,"15","267","1","0","2","270"
"Carbon",1991,"16","271","0","0","2","273"
"Carbon",1991,"17","280","0","1","2","283"
"Carbon",1991,"18 to 20","538","5","8","3","554"
"Carbon",1991,"21 to 24","655","3","12","5","675"
"Carbon",1991,"25 & over","10197","55","76","33","10361"
"Carbon",1991,"Total","16132","85","128","61","16406"
"Uinta",2011,"0","299","9","8","4","320"
"Uinta",2011,"1","319","6","6","5","336"
"Uinta",2011,"2","326","6","5","2","339"
"Uinta",2011,"3","351","4","2","0","357"
"Uinta",2011,"4","354","4","4","0","362"
"Uinta",2011,"5","344","3","3","4","354"
"Uinta",2011,"6","334","1","5","3","343"
"Uinta",2011,"7","369","1","9","2","381"
"Uinta",2011,"8","340","3","4","2","349"
"Uinta",2011,"9","370","4","4","4","382"
"Uinta",2011,"10","335","4","4","4","347"
"Uinta",2011,"11","351","4","5","0","360"
"Uinta",2011,"12","330","3","3","4","340"
"Uinta",2011,"13","353","2","7","3","365"
"Uinta",2011,"14","343","1","2","2","348"
"Uinta",2011,"15","313","2","5","3","323"
"Uinta",2011,"16","302","4","5","1","312"
"Uinta",2011,"17","344","4","5","4","357"
"Uinta",2011,"18 to 20","724","14","17","5","760"
"Uinta",2011,"21 to 24","825","6","12","7","850"
"Uinta",2011,"25 & over","12746","54","160","73","13033"
"Uinta",2011,"Total","20372","139","275","132","20918"
"Fremont",1998,"0","301","1","170","1","473"
"Fremont",1998,"1","316","6","142","0","464"
"Fremont",1998,"2","326","0","142","2","470"
"Fremont",1998,"3","309","0","155","0","464"
"Fremont",1998,"4","310","0","151","2","463"
"Fremont",1998,"5","327","2","174","1","504"
"Fremont",1998,"6","366","0","202","0","568"
"Fremont",1998,"7","350","0","190","1","541"
"Fremont",1998,"8","392","0","161","2","555"
"Fremont",1998,"9","408","0","168","2","578"
"Fremont",1998,"10","365","3","145","4","517"
"Fremont",1998,"11","418","0","184","4","606"
"Fremont",1998,"12","435","0","161","1","597"
"Fremont",1998,"13","490","2","204","1","697"
"Fremont",1998,"14","520","0","165","1","686"
"Fremont",1998,"15","492","0","162","1","655"
"Fremont",1998,"16","504","4","158","2","668"
"Fremont",1998,"17","494","0","149","0","643"
"Fremont",1998,"18 to 20","1125","2","421","2","1550"
"Fremont",1998,"21 to 24","1005","5","360","11","1381"
"Fremont",1998,"25 & over","19190","21","3349","64","22624"
"Fremont",1998,"Total","28443","46","7113","102","35704"
"Johnson",1998,"0","61","0","1","0","62"
"Johnson",1998,"1","76","0","0","0","76"
"Johnson",1998,"2","69","0","0","0","69"
"Johnson",1998,"3","78","0","0","0","78"
"Johnson",1998,"4","75","0","0","0","75"
"Johnson",1998,"5","78","0","1","0","79"
"Johnson",1998,"6","84","0","5","0","89"
"Johnson",1998,"7","95","0","0","0","95"
"Johnson",1998,"8","93","0","3","0","96"
"Johnson",1998,"9","97","0","2","0","99"
"Johnson",1998,"10","103","0","2","0","105"
"Johnson",1998,"11","100","0","0","0","100"
"Johnson",1998,"12","100","0","0","0","100"
"Johnson",1998,"13","95","0","1","0","96"
"Johnson",1998,"14","115","0","4","0","119"
"Johnson",1998,"15","111","0","1","1","113"
"Johnson",1998,"16","120","0","0","0","120"
"Johnson",1998,"17","136","0","0","0","136"
"Johnson",1998,"18 to 20","209","0","0","0","209"
"Johnson",1998,"21 to 24","190","0","0","0","190"
"Johnson",1998,"25 & over","4748","0","18","0","4766"
"Johnson",1998,"Total","6833","0","38","1","6872"
"Albany",2002,"0","340","10","4","12","366"
"Albany",2002,"1","334","8","3","4","349"
"Albany",2002,"2","280","16","6","9","311"
"Albany",2002,"3","271","9","4","6","290"
"Albany",2002,"4","283","14","4","7","308"
"Albany",2002,"5","281","10","4","4","299"
"Albany",2002,"6","257","7","7","8","279"
"Albany",2002,"7","289","9","6","7","311"
"Albany",2002,"8","258","11","4","3","276"
"Albany",2002,"9","311","4","5","5","325"
"Albany",2002,"10","273","8","8","4","293"
"Albany",2002,"11","277","8","5","9","299"
"Albany",2002,"12","306","7","4","7","324"
"Albany",2002,"13","273","6","4","5","288"
"Albany",2002,"14","280","7","7","6","300"
"Albany",2002,"15","323","7","5","4","339"
"Albany",2002,"16","312","3","10","2","327"
"Albany",2002,"17","331","7","4","3","345"
"Albany",2002,"18 to 20","4346","60","40","76","4522"
"Albany",2002,"21 to 24","5607","117","71","150","5945"
"Albany",2002,"25 & over","15865","171","199","344","16579"
"Albany",2002,"Total","31097","499","404","675","32675"
"Laramie",1996,"0","1057","47","12","13","1129"
"Laramie",1996,"1","1029","49","6","26","1110"
"Laramie",1996,"2","1017","40","10","20","1087"
"Laramie",1996,"3","1018","52","9","17","1096"
"Laramie",1996,"4","989","48","23","20","1080"
"Laramie",1996,"5","1056","36","14","12","1118"
"Laramie",1996,"6","1089","56","17","11","1173"
"Laramie",1996,"7","1109","50","10","21","1190"
"Laramie",1996,"8","1047","58","8","18","1131"
"Laramie",1996,"9","1106","74","10","11","1201"
"Laramie",1996,"10","1141","39","12","21","1213"
"Laramie",1996,"11","1177","48","18","15","1258"
"Laramie",1996,"12","1171","47","14","16","1248"
"Laramie",1996,"13","1235","32","13","20","1300"
"Laramie",1996,"14","1221","36","21","12","1290"
"Laramie",1996,"15","1238","58","6","18","1320"
"Laramie",1996,"16","1218","40","15","14","1287"
"Laramie",1996,"17","1130","36","12","15","1193"
"Laramie",1996,"18 to 20","3127","146","42","49","3364"
"Laramie",1996,"21 to 24","4264","247","64","89","4664"
"Laramie",1996,"25 & over","48561","1213","397","563","50734"
"Laramie",1996,"Total","76000","2452","733","1001","80186"
"Weston",1995,"0","62","0","2","0","64"
"Weston",1995,"1","76","0","0","0","76"
"Weston",1995,"2","76","0","4","0","80"
"Weston",1995,"3","77","0","1","0","78"
"Weston",1995,"4","83","0","3","0","86"
"Weston",1995,"5","81","0","0","0","81"
"Weston",1995,"6","88","0","0","0","88"
"Weston",1995,"7","88","0","0","0","88"
"Weston",1995,"8","91","0","0","0","91"
"Weston",1995,"9","103","0","5","0","108"
"Weston",1995,"10","111","0","4","0","115"
"Weston",1995,"11","128","0","2","0","130"
"Weston",1995,"12","118","0","0","0","118"
"Weston",1995,"13","136","0","0","0","136"
"Weston",1995,"14","117","0","0","0","117"
"Weston",1995,"15","135","0","0","0","135"
"Weston",1995,"16","111","0","0","0","111"
"Weston",1995,"17","112","0","2","0","114"
"Weston",1995,"18 to 20","233","0","13","0","246"
"Weston",1995,"21 to 24","230","0","5","0","235"
"Weston",1995,"25 & over","4395","0","25","4","4424"
"Weston",1995,"Total","6651","0","66","4","6721"
"Sheridan",2013,"0","290","5","8","7","310"
"Sheridan",2013,"1","296","4","8","2","310"
"Sheridan",2013,"2","326","6","9","10","351"
"Sheridan",2013,"3","354","9","5","4","372"
"Sheridan",2013,"4","329","4","8","1","342"
"Sheridan",2013,"5","376","6","10","4","396"
"Sheridan",2013,"6","370","6","8","2","386"
"Sheridan",2013,"7","354","2","6","2","364"
"Sheridan",2013,"8","323","3","4","3","333"
"Sheridan",2013,"9","337","3","8","1","349"
"Sheridan",2013,"10","352","11","5","2","370"
"Sheridan",2013,"11","312","7","6","1","326"
"Sheridan",2013,"12","309","6","9","3","327"
"Sheridan",2013,"13","370","6","11","1","388"
"Sheridan",2013,"14","349","3","4","3","359"
"Sheridan",2013,"15","343","6","10","1","360"
"Sheridan",2013,"16","370","7","10","3","390"
"Sheridan",2013,"17","311","6","12","2","331"
"Sheridan",2013,"18 to 20","1065","38","36","17","1156"
"Sheridan",2013,"21 to 24","1264","28","37","11","1340"
"Sheridan",2013,"25 & over","20220","266","243","188","20917"
"Sheridan",2013,"Total","28620","432","457","268","29777"
"Lincoln",1996,"0","202","0","2","0","204"
"Lincoln",1996,"1","209","0","2","1","212"
"Lincoln",1996,"2","211","0","2","1","214"
"Lincoln",1996,"3","202","0","0","1","203"
"Lincoln",1996,"4","206","0","0","1","207"
"Lincoln",1996,"5","221","2","0","0","223"
"Lincoln",1996,"6","253","0","0","1","254"
"Lincoln",1996,"7","253","0","0","0","253"
"Lincoln",1996,"8","257","0","3","0","260"
"Lincoln",1996,"9","293","0","2","0","295"
"Lincoln",1996,"10","260","1","8","2","271"
"Lincoln",1996,"11","324","0","0","0","324"
"Lincoln",1996,"12","300","0","1","0","301"
"Lincoln",1996,"13","333","0","3","0","336"
"Lincoln",1996,"14","314","0","0","0","314"
"Lincoln",1996,"15","330","3","2","0","335"
"Lincoln",1996,"16","326","0","1","0","327"
"Lincoln",1996,"17","318","0","0","0","318"
"Lincoln",1996,"18 to 20","515","3","6","0","524"
"Lincoln",1996,"21 to 24","450","0","0","0","450"
"Lincoln",1996,"25 & over","8329","1","29","22","8381"
"Lincoln",1996,"Total","14106","10","61","29","14206"
"Teton",1997,"0","187","0","1","2","190"
"Teton",1997,"1","176","2","0","3","181"
"Teton",1997,"2","181","0","1","0","182"
"Teton",1997,"3","182","0","0","1","183"
"Teton",1997,"4","161","0","2","0","163"
"Teton",1997,"5","172","0","3","0","175"
"Teton",1997,"6","166","0","0","0","166"
"Teton",1997,"7","177","3","1","0","181"
"Teton",1997,"8","189","0","0","2","191"
"Teton",1997,"9","184","1","0","0","185"
"Teton",1997,"10","207","1","1","0","209"
"Teton",1997,"11","208","0","0","0","208"
"Teton",1997,"12","199","0","0","0","199"
"Teton",1997,"13","207","0","0","0","207"
"Teton",1997,"14","204","0","2","2","208"
"Teton",1997,"15","193","1","1","2","197"
"Teton",1997,"16","213","0","3","0","216"
"Teton",1997,"17","194","0","0","0","194"
"Teton",1997,"18 to 20","454","0","6","0","460"
"Teton",1997,"21 to 24","1010","3","3","7","1023"
"Teton",1997,"25 & over","11156","5","59","44","11264"
"Teton",1997,"Total","16020","16","83","63","16182"
"Niobrara",2001,"0","21","0","0","0","21"
"Niobrara",2001,"1","14","1","0","0","15"
"Niobrara",2001,"2","19","1","0","0","20"
"Niobrara",2001,"3","25","0","0","0","25"
"Niobrara",2001,"4","34","0","0","0","34"
"Niobrara",2001,"5","25","0","0","0","25"
"Niobrara",2001,"6","24","0","0","0","24"
"Niobrara",2001,"7","19","0","0","0","19"
"Niobrara",2001,"8","30","0","0","0","30"
"Niobrara",2001,"9","39","1","0","0","40"
"Niobrara",2001,"10","32","0","1","0","33"
"Niobrara",2001,"11","39","0","0","0","39"
"Niobrara",2001,"12","31","0","0","0","31"
"Niobrara",2001,"13","26","0","0","0","26"
"Niobrara",2001,"14","41","0","0","0","41"
"Niobrara",2001,"15","33","0","0","0","33"
"Niobrara",2001,"16","39","0","0","1","40"
"Niobrara",2001,"17","38","0","0","0","38"
"Niobrara",2001,"18 to 20","80","1","0","0","81"
"Niobrara",2001,"21 to 24","65","1","0","0","66"
"Niobrara",2001,"25 & over","1663","1","10","2","1676"
"Niobrara",2001,"Total","2337","6","11","3","2357"
"Laramie",2002,"0","1045","90","17","25","1177"
"Laramie",2002,"1","1011","78","25","30","1144"
"Laramie",2002,"2","997","59","13","23","1092"
"Laramie",2002,"3","999","52","15","30","1096"
"Laramie",2002,"4","957","68","20","19","1064"
"Laramie",2002,"5","1043","40","12","14","1109"
"Laramie",2002,"6","987","33","16","13","1049"
"Laramie",2002,"7","1024","46","16","17","1103"
"Laramie",2002,"8","1096","41","22","18","1177"
"Laramie",2002,"9","1169","58","19","24","1270"
"Laramie",2002,"10","1103","55","18","15","1191"
"Laramie",2002,"11","1122","48","25","16","1211"
"Laramie",2002,"12","1150","29","12","11","1202"
"Laramie",2002,"13","1142","54","13","10","1219"
"Laramie",2002,"14","1091","40","13","20","1164"
"Laramie",2002,"15","1155","30","8","16","1209"
"Laramie",2002,"16","1181","38","17","14","1250"
"Laramie",2002,"17","1176","40","9","16","1241"
"Laramie",2002,"18 to 20","3226","213","46","70","3555"
"Laramie",2002,"21 to 24","4326","289","86","81","4782"
"Laramie",2002,"25 & over","51346","1293","591","691","53921"
"Laramie",2002,"Total","78346","2694","1013","1173","83226"
"Hot Springs",2004,"0","35","0","1","0","36"
"Hot Springs",2004,"1","37","1","3","0","41"
"Hot Springs",2004,"2","33","3","3","1","40"
"Hot Springs",2004,"3","36","1","0","0","37"
"Hot Springs",2004,"4","43","1","0","0","44"
"Hot Springs",2004,"5","51","0","1","0","52"
"Hot Springs",2004,"6","42","0","0","0","42"
"Hot Springs",2004,"7","41","1","1","1","44"
"Hot Springs",2004,"8","74","0","0","0","74"
"Hot Springs",2004,"9","45","0","1","0","46"
"Hot Springs",2004,"10","47","0","0","0","47"
"Hot Springs",2004,"11","47","0","3","0","50"
"Hot Springs",2004,"12","53","0","2","1","56"
"Hot Springs",2004,"13","57","0","2","1","60"
"Hot Springs",2004,"14","50","0","2","0","52"
"Hot Springs",2004,"15","56","0","3","1","60"
"Hot Springs",2004,"16","61","0","3","0","64"
"Hot Springs",2004,"17","65","0","1","0","66"
"Hot Springs",2004,"18 to 20","177","0","5","1","183"
"Hot Springs",2004,"21 to 24","160","1","5","1","167"
"Hot Springs",2004,"25 & over","3303","9","46","10","3368"
"Hot Springs",2004,"Total","4513","17","82","17","4629"
"Carbon",1993,"0","179","0","0","1","180"
"Carbon",1993,"1","198","0","4","1","203"
"Carbon",1993,"2","197","3","0","0","200"
"Carbon",1993,"3","203","0","5","0","208"
"Carbon",1993,"4","216","0","0","0","216"
"Carbon",1993,"5","228","1","7","0","236"
"Carbon",1993,"6","237","1","1","0","239"
"Carbon",1993,"7","238","1","0","1","240"
"Carbon",1993,"8","237","4","8","1","250"
"Carbon",1993,"9","247","1","0","5","253"
"Carbon",1993,"10","279","3","2","3","287"
"Carbon",1993,"11","287","3","6","0","296"
"Carbon",1993,"12","299","3","0","2","304"
"Carbon",1993,"13","287","0","0","0","287"
"Carbon",1993,"14","291","0","0","2","293"
"Carbon",1993,"15","276","0","0","2","278"
"Carbon",1993,"16","273","0","0","2","275"
"Carbon",1993,"17","278","0","1","2","281"
"Carbon",1993,"18 to 20","557","5","11","4","577"
"Carbon",1993,"21 to 24","715","4","14","4","737"
"Carbon",1993,"25 & over","10246","61","98","37","10442"
"Carbon",1993,"Total","15968","90","157","67","16282"
"Hot Springs",1992,"0","50","0","0","0","50"
"Hot Springs",1992,"1","38","0","1","0","39"
"Hot Springs",1992,"2","46","0","5","0","51"
"Hot Springs",1992,"3","47","0","0","0","47"
"Hot Springs",1992,"4","50","0","2","0","52"
"Hot Springs",1992,"5","57","0","1","0","58"
"Hot Springs",1992,"6","60","0","5","0","65"
"Hot Springs",1992,"7","57","0","1","0","58"
"Hot Springs",1992,"8","65","0","4","0","69"
"Hot Springs",1992,"9","85","0","1","0","86"
"Hot Springs",1992,"10","78","0","2","0","80"
"Hot Springs",1992,"11","76","0","2","0","78"
"Hot Springs",1992,"12","85","0","7","0","92"
"Hot Springs",1992,"13","86","0","1","0","87"
"Hot Springs",1992,"14","89","0","4","0","93"
"Hot Springs",1992,"15","74","0","2","0","76"
"Hot Springs",1992,"16","75","0","2","0","77"
"Hot Springs",1992,"17","82","0","2","0","84"
"Hot Springs",1992,"18 to 20","129","2","4","0","135"
"Hot Springs",1992,"21 to 24","119","0","1","0","120"
"Hot Springs",1992,"25 & over","3283","0","42","0","3325"
"Hot Springs",1992,"Total","4731","2","89","0","4822"
"Uinta",2015,"0","293","7","6","1","307"
"Uinta",2015,"1","323","8","11","2","344"
"Uinta",2015,"2","314","7","4","6","331"
"Uinta",2015,"3","320","6","7","1","334"
"Uinta",2015,"4","313","13","7","4","337"
"Uinta",2015,"5","341","8","6","5","360"
"Uinta",2015,"6","332","3","5","5","345"
"Uinta",2015,"7","361","4","3","3","371"
"Uinta",2015,"8","336","5","4","2","347"
"Uinta",2015,"9","352","7","3","4","366"
"Uinta",2015,"10","323","3","7","1","334"
"Uinta",2015,"11","367","3","8","2","380"
"Uinta",2015,"12","313","2","4","2","321"
"Uinta",2015,"13","360","3","4","4","371"
"Uinta",2015,"14","319","6","4","1","330"
"Uinta",2015,"15","333","3","5","1","342"
"Uinta",2015,"16","310","3","4","3","320"
"Uinta",2015,"17","320","3","5","3","331"
"Uinta",2015,"18 to 20","653","10","9","5","677"
"Uinta",2015,"21 to 24","865","17","20","4","906"
"Uinta",2015,"25 & over","12698","111","162","94","13065"
"Uinta",2015,"Total","20146","232","288","153","20819"
"Sweetwater",1999,"0","512","13","5","1","531"
"Sweetwater",1999,"1","538","6","7","3","554"
"Sweetwater",1999,"2","506","8","13","0","527"
"Sweetwater",1999,"3","504","17","10","0","531"
"Sweetwater",1999,"4","491","7","4","0","502"
"Sweetwater",1999,"5","492","7","7","2","508"
"Sweetwater",1999,"6","568","8","14","2","592"
"Sweetwater",1999,"7","557","11","19","4","591"
"Sweetwater",1999,"8","614","0","6","2","622"
"Sweetwater",1999,"9","622","5","8","3","638"
"Sweetwater",1999,"10","571","1","12","2","586"
"Sweetwater",1999,"11","598","7","14","3","622"
"Sweetwater",1999,"12","656","10","8","2","676"
"Sweetwater",1999,"13","725","3","10","1","739"
"Sweetwater",1999,"14","711","6","10","2","729"
"Sweetwater",1999,"15","702","14","8","2","726"
"Sweetwater",1999,"16","768","7","7","8","790"
"Sweetwater",1999,"17","798","2","12","6","818"
"Sweetwater",1999,"18 to 20","1922","18","22","35","1997"
"Sweetwater",1999,"21 to 24","1763","16","21","25","1825"
"Sweetwater",1999,"25 & over","22477","175","209","177","23038"
"Sweetwater",1999,"Total","37095","341","426","280","38142"
"Park",2016,"0","286","14","6","4","310"
"Park",2016,"1","314","13","6","8","341"
"Park",2016,"2","316","6","6","6","334"
"Park",2016,"3","304","7","5","7","323"
"Park",2016,"4","340","7","5","3","355"
"Park",2016,"5","299","8","2","7","316"
"Park",2016,"6","304","2","4","5","315"
"Park",2016,"7","350","4","2","2","358"
"Park",2016,"8","330","3","2","2","337"
"Park",2016,"9","342","3","3","3","351"
"Park",2016,"10","345","3","8","3","359"
"Park",2016,"11","350","2","2","3","357"
"Park",2016,"12","319","3","6","1","329"
"Park",2016,"13","336","3","4","4","347"
"Park",2016,"14","324","0","7","1","332"
"Park",2016,"15","323","3","5","1","332"
"Park",2016,"16","314","5","7","3","329"
"Park",2016,"17","321","3","3","3","330"
"Park",2016,"18 to 20","1033","29","28","28","1118"
"Park",2016,"21 to 24","1223","70","18","19","1330"
"Park",2016,"25 & over","20363","159","170","158","20850"
"Park",2016,"Total","28436","347","299","271","29353"
"Campbell",2011,"0","681","12","21","4","718"
"Campbell",2011,"1","816","8","21","6","851"
"Campbell",2011,"2","757","12","17","4","790"
"Campbell",2011,"3","810","7","16","1","834"
"Campbell",2011,"4","789","8","24","2","823"
"Campbell",2011,"5","736","6","16","4","762"
"Campbell",2011,"6","739","2","14","1","756"
"Campbell",2011,"7","726","11","16","4","757"
"Campbell",2011,"8","678","7","21","6","712"
"Campbell",2011,"9","645","7","17","1","670"
"Campbell",2011,"10","685","6","15","4","710"
"Campbell",2011,"11","680","5","12","8","705"
"Campbell",2011,"12","667","6","14","8","695"
"Campbell",2011,"13","683","11","8","2","704"
"Campbell",2011,"14","625","7","13","2","647"
"Campbell",2011,"15","625","7","14","6","652"
"Campbell",2011,"16","632","4","9","2","647"
"Campbell",2011,"17","632","6","15","3","656"
"Campbell",2011,"18 to 20","1631","39","52","10","1732"
"Campbell",2011,"21 to 24","2511","27","49","24","2611"
"Campbell",2011,"25 & over","28407","156","397","202","29162"
"Campbell",2011,"Total","45155","354","781","304","46594"
"Uinta",2000,"0","307","1","2","0","310"
"Uinta",2000,"1","317","1","5","1","324"
"Uinta",2000,"2","312","1","2","0","315"
"Uinta",2000,"3","305","0","1","2","308"
"Uinta",2000,"4","346","5","2","3","356"
"Uinta",2000,"5","295","2","5","2","304"
"Uinta",2000,"6","337","1","2","2","342"
"Uinta",2000,"7","306","4","5","3","318"
"Uinta",2000,"8","316","1","1","0","318"
"Uinta",2000,"9","339","0","4","3","346"
"Uinta",2000,"10","396","3","3","2","404"
"Uinta",2000,"11","353","1","3","3","360"
"Uinta",2000,"12","402","2","5","1","410"
"Uinta",2000,"13","393","0","3","1","397"
"Uinta",2000,"14","414","0","7","1","422"
"Uinta",2000,"15","411","1","12","0","424"
"Uinta",2000,"16","461","0","3","2","466"
"Uinta",2000,"17","435","0","5","3","443"
"Uinta",2000,"18 to 20","872","2","20","2","896"
"Uinta",2000,"21 to 24","852","0","8","5","865"
"Uinta",2000,"25 & over","11175","15","104","44","11338"
"Uinta",2000,"Total","19344","40","202","80","19666"
"Campbell",1999,"0","453","0","6","3","462"
"Campbell",1999,"1","485","2","9","2","498"
"Campbell",1999,"2","525","3","4","1","533"
"Campbell",1999,"3","455","0","5","1","461"
"Campbell",1999,"4","481","3","5","1","490"
"Campbell",1999,"5","500","0","8","0","508"
"Campbell",1999,"6","529","0","7","1","537"
"Campbell",1999,"7","516","0","9","0","525"
"Campbell",1999,"8","542","0","5","1","548"
"Campbell",1999,"9","596","0","10","9","615"
"Campbell",1999,"10","548","5","12","4","569"
"Campbell",1999,"11","564","0","8","0","572"
"Campbell",1999,"12","620","0","12","10","642"
"Campbell",1999,"13","641","0","12","3","656"
"Campbell",1999,"14","669","0","12","0","681"
"Campbell",1999,"15","704","1","7","8","720"
"Campbell",1999,"16","699","3","11","1","714"
"Campbell",1999,"17","646","1","15","3","665"
"Campbell",1999,"18 to 20","1403","2","15","0","1420"
"Campbell",1999,"21 to 24","1604","4","25","12","1645"
"Campbell",1999,"25 & over","19127","15","179","62","19383"
"Campbell",1999,"Total","32307","39","376","122","32844"
"Crook",2003,"0","66","0","1","0","67"
"Crook",2003,"1","63","0","1","0","64"
"Crook",2003,"2","58","0","1","0","59"
"Crook",2003,"3","66","0","0","0","66"
"Crook",2003,"4","71","0","2","1","74"
"Crook",2003,"5","58","1","2","0","61"
"Crook",2003,"6","63","0","2","0","65"
"Crook",2003,"7","76","1","0","0","77"
"Crook",2003,"8","64","0","2","1","67"
"Crook",2003,"9","65","0","1","0","66"
"Crook",2003,"10","80","1","0","0","81"
"Crook",2003,"11","84","0","3","0","87"
"Crook",2003,"12","93","0","1","0","94"
"Crook",2003,"13","86","0","0","0","86"
"Crook",2003,"14","88","0","1","0","89"
"Crook",2003,"15","101","0","4","0","105"
"Crook",2003,"16","119","0","1","0","120"
"Crook",2003,"17","120","0","1","0","121"
"Crook",2003,"18 to 20","245","1","1","0","247"
"Crook",2003,"21 to 24","227","0","3","0","230"
"Crook",2003,"25 & over","4018","3","31","3","4055"
"Crook",2003,"Total","5911","7","58","5","5981"
"Laramie",2014,"0","1092","76","32","23","1223"
"Laramie",2014,"1","1204","78","43","22","1347"
"Laramie",2014,"2","1072","78","22","19","1191"
"Laramie",2014,"3","1168","74","24","14","1280"
"Laramie",2014,"4","1164","61","22","20","1267"
"Laramie",2014,"5","1179","66","26","23","1294"
"Laramie",2014,"6","1261","73","32","24","1390"
"Laramie",2014,"7","1241","54","18","19","1332"
"Laramie",2014,"8","1201","63","31","28","1323"
"Laramie",2014,"9","1148","59","28","25","1260"
"Laramie",2014,"10","1180","36","25","28","1269"
"Laramie",2014,"11","1148","49","28","23","1248"
"Laramie",2014,"12","1110","41","20","17","1188"
"Laramie",2014,"13","1076","61","28","20","1185"
"Laramie",2014,"14","1136","46","16","12","1210"
"Laramie",2014,"15","1091","69","35","19","1214"
"Laramie",2014,"16","1064","74","28","19","1185"
"Laramie",2014,"17","1088","70","14","14","1186"
"Laramie",2014,"18 to 20","3193","244","57","73","3567"
"Laramie",2014,"21 to 24","5267","427","103","148","5945"
"Laramie",2014,"25 & over","60512","1850","800","998","64160"
"Laramie",2014,"Total","89595","3649","1432","1588","96264"
"Converse",2004,"0","121","0","3","1","125"
"Converse",2004,"1","164","2","3","1","170"
"Converse",2004,"2","151","1","2","0","154"
"Converse",2004,"3","165","2","3","0","170"
"Converse",2004,"4","153","1","5","0","159"
"Converse",2004,"5","163","3","2","1","169"
"Converse",2004,"6","149","1","1","0","151"
"Converse",2004,"7","147","3","4","1","155"
"Converse",2004,"8","172","1","0","0","173"
"Converse",2004,"9","173","2","2","1","178"
"Converse",2004,"10","171","4","2","1","178"
"Converse",2004,"11","169","2","3","0","174"
"Converse",2004,"12","192","3","2","0","197"
"Converse",2004,"13","191","1","1","1","194"
"Converse",2004,"14","212","4","2","0","218"
"Converse",2004,"15","187","0","0","0","187"
"Converse",2004,"16","216","0","2","1","219"
"Converse",2004,"17","239","2","3","1","245"
"Converse",2004,"18 to 20","465","1","4","4","474"
"Converse",2004,"21 to 24","552","0","5","2","559"
"Converse",2004,"25 & over","7983","15","75","28","8101"
"Converse",2004,"Total","12135","48","124","43","12350"
"Park",2010,"0","284","3","2","2","291"
"Park",2010,"1","316","2","3","1","322"
"Park",2010,"2","333","2","2","2","339"
"Park",2010,"3","326","2","2","2","332"
"Park",2010,"4","337","0","5","1","343"
"Park",2010,"5","321","2","2","2","327"
"Park",2010,"6","314","3","2","1","320"
"Park",2010,"7","320","3","4","1","328"
"Park",2010,"8","299","0","6","1","306"
"Park",2010,"9","300","1","4","2","307"
"Park",2010,"10","310","2","6","2","320"
"Park",2010,"11","300","4","5","2","311"
"Park",2010,"12","341","3","9","3","356"
"Park",2010,"13","323","5","6","7","341"
"Park",2010,"14","325","2","3","4","334"
"Park",2010,"15","339","3","3","3","348"
"Park",2010,"16","327","2","5","0","334"
"Park",2010,"17","344","4","3","0","351"
"Park",2010,"18 to 20","1239","21","21","27","1308"
"Park",2010,"21 to 24","1138","12","8","22","1180"
"Park",2010,"25 & over","19576","39","121","124","19860"
"Park",2010,"Total","27712","115","222","209","28258"
"Weston",2003,"0","61","0","2","0","63"
"Weston",2003,"1","59","1","2","1","63"
"Weston",2003,"2","61","0","2","0","63"
"Weston",2003,"3","60","0","2","0","62"
"Weston",2003,"4","72","0","2","0","74"
"Weston",2003,"5","74","0","0","0","74"
"Weston",2003,"6","85","0","2","1","88"
"Weston",2003,"7","65","0","0","0","65"
"Weston",2003,"8","66","1","2","1","70"
"Weston",2003,"9","68","0","2","0","70"
"Weston",2003,"10","70","0","1","0","71"
"Weston",2003,"11","77","1","2","1","81"
"Weston",2003,"12","75","1","0","0","76"
"Weston",2003,"13","94","1","1","0","96"
"Weston",2003,"14","101","0","2","0","103"
"Weston",2003,"15","106","0","2","0","108"
"Weston",2003,"16","110","0","1","0","111"
"Weston",2003,"17","112","1","2","0","115"
"Weston",2003,"18 to 20","276","0","10","0","286"
"Weston",2003,"21 to 24","304","3","5","0","312"
"Weston",2003,"25 & over","4498","5","48","8","4559"
"Weston",2003,"Total","6494","14","90","12","6610"
"Laramie",2016,"0","1096","62","25","32","1215"
"Laramie",2016,"1","1117","81","25","25","1248"
"Laramie",2016,"2","1087","72","24","25","1208"
"Laramie",2016,"3","1214","65","22","21","1322"
"Laramie",2016,"4","1170","61","26","35","1292"
"Laramie",2016,"5","1176","68","26","16","1286"
"Laramie",2016,"6","1177","55","20","15","1267"
"Laramie",2016,"7","1246","56","30","28","1360"
"Laramie",2016,"8","1282","72","26","30","1410"
"Laramie",2016,"9","1226","50","16","23","1315"
"Laramie",2016,"10","1245","59","38","27","1369"
"Laramie",2016,"11","1178","56","23","26","1283"
"Laramie",2016,"12","1203","34","28","32","1297"
"Laramie",2016,"13","1192","57","23","21","1293"
"Laramie",2016,"14","1113","36","19","19","1187"
"Laramie",2016,"15","1091","77","22","24","1214"
"Laramie",2016,"16","1139","60","16","14","1229"
"Laramie",2016,"17","1102","49","30","18","1199"
"Laramie",2016,"18 to 20","3137","222","57","56","3472"
"Laramie",2016,"21 to 24","5150","419","111","127","5807"
"Laramie",2016,"25 & over","62067","1881","793","1122","65863"
"Laramie",2016,"Total","91408","3592","1400","1736","98136"
"Big Horn",1990,"0","152","0","0","0","152"
"Big Horn",1990,"1","144","0","2","0","146"
"Big Horn",1990,"2","165","0","0","0","165"
"Big Horn",1990,"3","165","0","0","0","165"
"Big Horn",1990,"4","160","0","2","0","162"
"Big Horn",1990,"5","156","0","5","2","163"
"Big Horn",1990,"6","172","0","0","0","172"
"Big Horn",1990,"7","195","0","0","0","195"
"Big Horn",1990,"8","184","0","0","0","184"
"Big Horn",1990,"9","206","0","0","0","206"
"Big Horn",1990,"10","202","0","2","1","205"
"Big Horn",1990,"11","177","0","1","0","178"
"Big Horn",1990,"12","191","0","1","0","192"
"Big Horn",1990,"13","184","0","0","0","184"
"Big Horn",1990,"14","192","0","0","1","193"
"Big Horn",1990,"15","177","0","2","0","179"
"Big Horn",1990,"16","177","0","0","0","177"
"Big Horn",1990,"17","189","0","2","3","194"
"Big Horn",1990,"18 to 20","316","0","5","0","321"
"Big Horn",1990,"21 to 24","349","0","0","0","349"
"Big Horn",1990,"25 & over","6564","0","29","12","6605"
"Big Horn",1990,"Total","10417","0","51","19","10487"
"Johnson",1991,"0","72","0","1","0","73"
"Johnson",1991,"1","85","0","0","0","85"
"Johnson",1991,"2","73","0","0","0","73"
"Johnson",1991,"3","70","0","0","0","70"
"Johnson",1991,"4","78","0","0","0","78"
"Johnson",1991,"5","81","0","1","0","82"
"Johnson",1991,"6","85","0","2","0","87"
"Johnson",1991,"7","88","0","0","0","88"
"Johnson",1991,"8","91","0","5","0","96"
"Johnson",1991,"9","105","0","1","0","106"
"Johnson",1991,"10","107","0","1","0","108"
"Johnson",1991,"11","112","0","0","0","112"
"Johnson",1991,"12","96","0","0","0","96"
"Johnson",1991,"13","90","0","2","0","92"
"Johnson",1991,"14","97","0","4","0","101"
"Johnson",1991,"15","91","0","3","1","95"
"Johnson",1991,"16","114","0","0","0","114"
"Johnson",1991,"17","90","0","0","0","90"
"Johnson",1991,"18 to 20","203","0","0","0","203"
"Johnson",1991,"21 to 24","185","0","0","0","185"
"Johnson",1991,"25 & over","4164","0","11","0","4175"
"Johnson",1991,"Total","6177","0","31","1","6209"
"Sheridan",2007,"0","351","3","6","1","361"
"Sheridan",2007,"1","269","1","10","3","283"
"Sheridan",2007,"2","346","2","13","3","364"
"Sheridan",2007,"3","306","2","8","3","319"
"Sheridan",2007,"4","363","1","6","3","373"
"Sheridan",2007,"5","273","2","5","3","283"
"Sheridan",2007,"6","309","5","9","0","323"
"Sheridan",2007,"7","361","3","5","2","371"
"Sheridan",2007,"8","288","0","4","1","293"
"Sheridan",2007,"9","282","3","5","1","291"
"Sheridan",2007,"10","325","4","10","2","341"
"Sheridan",2007,"11","290","4","7","1","302"
"Sheridan",2007,"12","318","3","8","0","329"
"Sheridan",2007,"13","335","2","3","1","341"
"Sheridan",2007,"14","366","1","10","6","383"
"Sheridan",2007,"15","341","3","18","2","364"
"Sheridan",2007,"16","352","4","19","4","379"
"Sheridan",2007,"17","407","4","12","1","424"
"Sheridan",2007,"18 to 20","1017","13","26","13","1069"
"Sheridan",2007,"21 to 24","1223","13","18","15","1269"
"Sheridan",2007,"25 & over","18972","62","219","130","19383"
"Sheridan",2007,"Total","27094","135","421","195","27845"
"Crook",2015,"0","102","2","1","0","105"
"Crook",2015,"1","118","0","2","0","120"
"Crook",2015,"2","91","0","0","0","91"
"Crook",2015,"3","113","2","1","1","117"
"Crook",2015,"4","99","1","2","0","102"
"Crook",2015,"5","116","0","1","0","117"
"Crook",2015,"6","82","1","2","0","85"
"Crook",2015,"7","111","1","1","1","114"
"Crook",2015,"8","103","0","3","1","107"
"Crook",2015,"9","93","0","3","1","97"
"Crook",2015,"10","103","1","2","0","106"
"Crook",2015,"11","84","1","1","0","86"
"Crook",2015,"12","101","0","2","0","103"
"Crook",2015,"13","97","1","3","1","102"
"Crook",2015,"14","96","2","3","0","101"
"Crook",2015,"15","101","2","1","0","104"
"Crook",2015,"16","79","0","2","0","81"
"Crook",2015,"17","80","1","0","0","81"
"Crook",2015,"18 to 20","216","1","3","0","220"
"Crook",2015,"21 to 24","263","5","3","0","271"
"Crook",2015,"25 & over","4979","61","47","17","5104"
"Crook",2015,"Total","7227","82","83","22","7414"
"Campbell",2004,"0","558","5","20","3","586"
"Campbell",2004,"1","534","9","11","3","557"
"Campbell",2004,"2","540","6","22","3","571"
"Campbell",2004,"3","504","5","20","2","531"
"Campbell",2004,"4","565","5","5","3","578"
"Campbell",2004,"5","566","3","14","0","583"
"Campbell",2004,"6","585","8","7","4","604"
"Campbell",2004,"7","509","5","10","4","528"
"Campbell",2004,"8","526","6","8","2","542"
"Campbell",2004,"9","520","4","7","6","537"
"Campbell",2004,"10","569","4","11","0","584"
"Campbell",2004,"11","567","2","12","3","584"
"Campbell",2004,"12","614","4","8","3","629"
"Campbell",2004,"13","605","3","13","2","623"
"Campbell",2004,"14","606","5","13","3","627"
"Campbell",2004,"15","615","2","11","4","632"
"Campbell",2004,"16","617","2","11","3","633"
"Campbell",2004,"17","659","4","12","1","676"
"Campbell",2004,"18 to 20","1612","15","29","10","1666"
"Campbell",2004,"21 to 24","2112","7","44","17","2180"
"Campbell",2004,"25 & over","22005","63","255","133","22456"
"Campbell",2004,"Total","35988","167","543","209","36907"
"Uinta",1990,"0","356","1","1","0","358"
"Uinta",1990,"1","377","1","2","1","381"
"Uinta",1990,"2","333","1","2","0","336"
"Uinta",1990,"3","346","1","0","3","350"
"Uinta",1990,"4","378","3","2","4","387"
"Uinta",1990,"5","418","3","1","1","423"
"Uinta",1990,"6","462","2","1","3","468"
"Uinta",1990,"7","447","0","7","3","457"
"Uinta",1990,"8","448","1","1","0","450"
"Uinta",1990,"9","456","0","2","5","463"
"Uinta",1990,"10","466","2","4","4","476"
"Uinta",1990,"11","446","0","3","0","449"
"Uinta",1990,"12","424","0","3","0","427"
"Uinta",1990,"13","432","0","4","2","438"
"Uinta",1990,"14","410","0","2","0","412"
"Uinta",1990,"15","399","1","6","0","406"
"Uinta",1990,"16","385","0","3","2","390"
"Uinta",1990,"17","337","0","2","1","340"
"Uinta",1990,"18 to 20","647","0","3","4","654"
"Uinta",1990,"21 to 24","671","0","11","0","682"
"Uinta",1990,"25 & over","9801","4","60","26","9891"
"Uinta",1990,"Total","18439","20","120","59","18638"
"Park",2006,"0","317","3","5","0","325"
"Park",2006,"1","271","3","2","0","276"
"Park",2006,"2","278","1","3","1","283"
"Park",2006,"3","293","2","1","2","298"
"Park",2006,"4","290","0","2","2","294"
"Park",2006,"5","267","1","2","1","271"
"Park",2006,"6","276","3","2","1","282"
"Park",2006,"7","259","2","3","2","266"
"Park",2006,"8","314","2","4","0","320"
"Park",2006,"9","299","2","2","2","305"
"Park",2006,"10","343","2","5","3","353"
"Park",2006,"11","285","2","4","2","293"
"Park",2006,"12","301","4","8","4","317"
"Park",2006,"13","339","7","3","5","354"
"Park",2006,"14","350","1","1","2","354"
"Park",2006,"15","402","1","3","3","409"
"Park",2006,"16","373","1","4","0","378"
"Park",2006,"17","389","3","1","1","394"
"Park",2006,"18 to 20","1208","12","16","20","1256"
"Park",2006,"21 to 24","1231","7","7","15","1260"
"Park",2006,"25 & over","18268","30","110","93","18501"
"Park",2006,"Total","26353","89","188","159","26789"
"Teton",2013,"0","259","4","0","2","265"
"Teton",2013,"1","225","1","0","2","228"
"Teton",2013,"2","245","3","2","2","252"
"Teton",2013,"3","261","3","7","3","274"
"Teton",2013,"4","264","2","4","2","272"
"Teton",2013,"5","255","4","3","5","267"
"Teton",2013,"6","265","1","3","4","273"
"Teton",2013,"7","225","1","4","3","233"
"Teton",2013,"8","239","3","1","6","249"
"Teton",2013,"9","230","2","3","4","239"
"Teton",2013,"10","218","5","2","6","231"
"Teton",2013,"11","203","3","1","2","209"
"Teton",2013,"12","189","1","3","4","197"
"Teton",2013,"13","200","5","3","6","214"
"Teton",2013,"14","187","1","2","2","192"
"Teton",2013,"15","207","2","3","6","218"
"Teton",2013,"16","220","1","2","5","228"
"Teton",2013,"17","194","1","1","3","199"
"Teton",2013,"18 to 20","507","38","7","10","562"
"Teton",2013,"21 to 24","855","34","13","21","923"
"Teton",2013,"25 & over","15937","271","161","225","16594"
"Teton",2013,"Total","21385","386","225","323","22319"
"Converse",2009,"0","178","1","8","2","189"
"Converse",2009,"1","197","4","2","1","204"
"Converse",2009,"2","197","1","4","0","202"
"Converse",2009,"3","186","5","3","1","195"
"Converse",2009,"4","182","4","6","0","192"
"Converse",2009,"5","187","5","1","1","194"
"Converse",2009,"6","186","1","2","0","189"
"Converse",2009,"7","191","1","4","1","197"
"Converse",2009,"8","183","0","3","1","187"
"Converse",2009,"9","171","2","0","1","174"
"Converse",2009,"10","193","1","0","1","195"
"Converse",2009,"11","190","6","2","0","198"
"Converse",2009,"12","167","5","2","0","174"
"Converse",2009,"13","186","2","3","0","191"
"Converse",2009,"14","174","8","3","1","186"
"Converse",2009,"15","172","1","0","0","173"
"Converse",2009,"16","250","2","4","1","257"
"Converse",2009,"17","219","5","2","1","227"
"Converse",2009,"18 to 20","452","3","2","1","458"
"Converse",2009,"21 to 24","561","3","4","1","569"
"Converse",2009,"25 & over","9141","25","82","40","9288"
"Converse",2009,"Total","13563","85","137","54","13839"
"Campbell",2006,"0","652","5","24","5","686"
"Campbell",2006,"1","591","6","12","2","611"
"Campbell",2006,"2","614","6","8","1","629"
"Campbell",2006,"3","601","7","8","3","619"
"Campbell",2006,"4","566","4","18","5","593"
"Campbell",2006,"5","604","3","24","0","631"
"Campbell",2006,"6","616","6","12","4","638"
"Campbell",2006,"7","580","3","10","2","595"
"Campbell",2006,"8","594","9","11","0","614"
"Campbell",2006,"9","546","4","10","5","565"
"Campbell",2006,"10","583","5","12","1","601"
"Campbell",2006,"11","550","4","10","5","569"
"Campbell",2006,"12","635","7","7","4","653"
"Campbell",2006,"13","602","8","14","3","627"
"Campbell",2006,"14","628","6","11","3","648"
"Campbell",2006,"15","646","2","13","2","663"
"Campbell",2006,"16","611","5","13","3","632"
"Campbell",2006,"17","597","3","16","4","620"
"Campbell",2006,"18 to 20","1566","21","34","17","1638"
"Campbell",2006,"21 to 24","2329","13","49","19","2410"
"Campbell",2006,"25 & over","23707","79","311","158","24255"
"Campbell",2006,"Total","38418","206","627","246","39497"
"Goshen",1999,"0","141","0","2","0","143"
"Goshen",1999,"1","141","3","6","0","150"
"Goshen",1999,"2","141","0","1","0","142"
"Goshen",1999,"3","149","0","1","0","150"
"Goshen",1999,"4","146","0","1","0","147"
"Goshen",1999,"5","124","2","3","0","129"
"Goshen",1999,"6","177","0","9","0","186"
"Goshen",1999,"7","127","0","1","0","128"
"Goshen",1999,"8","183","0","3","0","186"
"Goshen",1999,"9","191","0","2","0","193"
"Goshen",1999,"10","189","4","1","4","198"
"Goshen",1999,"11","172","0","9","0","181"
"Goshen",1999,"12","185","0","4","0","189"
"Goshen",1999,"13","188","0","0","0","188"
"Goshen",1999,"14","191","0","0","0","191"
"Goshen",1999,"15","202","0","6","0","208"
"Goshen",1999,"16","198","0","0","0","198"
"Goshen",1999,"17","187","0","6","0","193"
"Goshen",1999,"18 to 20","655","4","5","6","670"
"Goshen",1999,"21 to 24","499","0","0","3","502"
"Goshen",1999,"25 & over","8181","7","37","5","8230"
"Goshen",1999,"Total","12367","20","97","18","12502"
"Laramie",1998,"0","1016","60","9","7","1092"
"Laramie",1998,"1","1045","33","7","25","1110"
"Laramie",1998,"2","1011","45","8","23","1087"
"Laramie",1998,"3","1004","56","8","17","1085"
"Laramie",1998,"4","975","43","30","17","1065"
"Laramie",1998,"5","1046","45","15","19","1125"
"Laramie",1998,"6","1060","46","22","16","1144"
"Laramie",1998,"7","1139","25","9","22","1195"
"Laramie",1998,"8","1118","65","11","14","1208"
"Laramie",1998,"9","1097","67","12","17","1193"
"Laramie",1998,"10","1087","41","13","20","1161"
"Laramie",1998,"11","1127","69","18","10","1224"
"Laramie",1998,"12","1158","36","12","16","1222"
"Laramie",1998,"13","1207","26","12","21","1266"
"Laramie",1998,"14","1185","46","25","12","1268"
"Laramie",1998,"15","1235","61","7","20","1323"
"Laramie",1998,"16","1216","23","17","13","1269"
"Laramie",1998,"17","1132","32","10","18","1192"
"Laramie",1998,"18 to 20","3114","180","50","48","3392"
"Laramie",1998,"21 to 24","4148","256","53","81","4538"
"Laramie",1998,"25 & over","49133","1231","404","595","51363"
"Laramie",1998,"Total","76253","2486","752","1031","80522"
"Lincoln",2016,"0","228","2","6","2","238"
"Lincoln",2016,"1","224","1","4","3","232"
"Lincoln",2016,"2","270","3","4","4","281"
"Lincoln",2016,"3","262","3","6","2","273"
"Lincoln",2016,"4","281","1","6","4","292"
"Lincoln",2016,"5","260","0","4","1","265"
"Lincoln",2016,"6","282","2","2","2","288"
"Lincoln",2016,"7","315","2","2","2","321"
"Lincoln",2016,"8","320","1","3","3","327"
"Lincoln",2016,"9","302","4","1","1","308"
"Lincoln",2016,"10","313","2","2","1","318"
"Lincoln",2016,"11","300","2","5","3","310"
"Lincoln",2016,"12","284","3","7","1","295"
"Lincoln",2016,"13","286","2","4","0","292"
"Lincoln",2016,"14","270","5","2","0","277"
"Lincoln",2016,"15","275","3","4","0","282"
"Lincoln",2016,"16","286","4","4","1","295"
"Lincoln",2016,"17","276","4","3","1","284"
"Lincoln",2016,"18 to 20","579","2","8","4","593"
"Lincoln",2016,"21 to 24","686","10","13","3","712"
"Lincoln",2016,"25 & over","12351","93","107","76","12627"
"Lincoln",2016,"Total","18650","149","197","114","19110"
"Weston",2014,"0","69","2","2","0","73"
"Weston",2014,"1","92","2","4","0","98"
"Weston",2014,"2","80","2","2","0","84"
"Weston",2014,"3","81","0","2","0","83"
"Weston",2014,"4","84","3","1","1","89"
"Weston",2014,"5","77","1","1","0","79"
"Weston",2014,"6","68","4","0","0","72"
"Weston",2014,"7","62","2","2","0","66"
"Weston",2014,"8","83","4","2","0","89"
"Weston",2014,"9","96","2","1","0","99"
"Weston",2014,"10","102","0","2","0","104"
"Weston",2014,"11","85","4","3","1","93"
"Weston",2014,"12","73","0","4","1","78"
"Weston",2014,"13","87","0","1","0","88"
"Weston",2014,"14","72","2","1","1","76"
"Weston",2014,"15","76","3","3","0","82"
"Weston",2014,"16","95","1","2","0","98"
"Weston",2014,"17","85","3","3","0","91"
"Weston",2014,"18 to 20","205","8","8","5","226"
"Weston",2014,"21 to 24","292","11","5","0","308"
"Weston",2014,"25 & over","4954","41","79","29","5103"
"Weston",2014,"Total","6918","95","128","38","7179"
"Goshen",1996,"0","148","0","2","0","150"
"Goshen",1996,"1","141","2","5","0","148"
"Goshen",1996,"2","140","0","1","0","141"
"Goshen",1996,"3","151","0","1","0","152"
"Goshen",1996,"4","150","0","1","0","151"
"Goshen",1996,"5","137","1","3","0","141"
"Goshen",1996,"6","182","0","7","0","189"
"Goshen",1996,"7","136","0","2","0","138"
"Goshen",1996,"8","174","0","1","0","175"
"Goshen",1996,"9","196","0","3","0","199"
"Goshen",1996,"10","198","6","2","2","208"
"Goshen",1996,"11","188","0","8","0","196"
"Goshen",1996,"12","198","0","4","0","202"
"Goshen",1996,"13","208","0","0","0","208"
"Goshen",1996,"14","208","0","0","0","208"
"Goshen",1996,"15","220","0","6","0","226"
"Goshen",1996,"16","215","0","0","0","215"
"Goshen",1996,"17","196","0","2","0","198"
"Goshen",1996,"18 to 20","627","6","4","5","642"
"Goshen",1996,"21 to 24","515","0","0","2","517"
"Goshen",1996,"25 & over","8118","5","36","9","8168"
"Goshen",1996,"Total","12446","20","88","18","12572"
"Sweetwater",2003,"0","555","15","15","6","591"
"Sweetwater",2003,"1","517","15","17","2","551"
"Sweetwater",2003,"2","505","18","17","3","543"
"Sweetwater",2003,"3","514","15","6","4","539"
"Sweetwater",2003,"4","526","9","5","2","542"
"Sweetwater",2003,"5","494","9","14","2","519"
"Sweetwater",2003,"6","473","4","10","4","491"
"Sweetwater",2003,"7","463","6","10","6","485"
"Sweetwater",2003,"8","455","7","4","3","469"
"Sweetwater",2003,"9","509","9","9","4","531"
"Sweetwater",2003,"10","521","9","10","2","542"
"Sweetwater",2003,"11","569","11","8","2","590"
"Sweetwater",2003,"12","572","4","6","1","583"
"Sweetwater",2003,"13","561","6","9","3","579"
"Sweetwater",2003,"14","555","5","8","2","570"
"Sweetwater",2003,"15","588","12","4","4","608"
"Sweetwater",2003,"16","641","9","7","4","661"
"Sweetwater",2003,"17","638","8","10","8","664"
"Sweetwater",2003,"18 to 20","1836","26","23","27","1912"
"Sweetwater",2003,"21 to 24","2191","32","33","37","2293"
"Sweetwater",2003,"25 & over","22494","212","263","218","23187"
"Sweetwater",2003,"Total","36177","441","488","344","37450"
"Natrona",2014,"0","1103","41","48","19","1211"
"Natrona",2014,"1","1075","34","35","9","1153"
"Natrona",2014,"2","997","35","26","13","1071"
"Natrona",2014,"3","1023","40","33","20","1116"
"Natrona",2014,"4","1081","31","17","11","1140"
"Natrona",2014,"5","1025","27","18","27","1097"
"Natrona",2014,"6","1094","31","25","17","1167"
"Natrona",2014,"7","1114","24","23","20","1181"
"Natrona",2014,"8","1075","29","25","6","1135"
"Natrona",2014,"9","1022","26","25","7","1080"
"Natrona",2014,"10","1034","21","25","15","1095"
"Natrona",2014,"11","998","24","22","15","1059"
"Natrona",2014,"12","953","16","14","7","990"
"Natrona",2014,"13","996","30","25","11","1062"
"Natrona",2014,"14","917","17","17","7","958"
"Natrona",2014,"15","935","32","22","18","1007"
"Natrona",2014,"16","907","37","17","8","969"
"Natrona",2014,"17","911","34","19","9","973"
"Natrona",2014,"18 to 20","2645","102","54","35","2836"
"Natrona",2014,"21 to 24","4403","104","114","51","4672"
"Natrona",2014,"25 & over","52296","869","731","564","54460"
"Natrona",2014,"Total","77604","1604","1335","889","81432"
"Fremont",1992,"0","327","0","195","1","523"
"Fremont",1992,"1","318","5","204","0","527"
"Fremont",1992,"2","358","0","166","3","527"
"Fremont",1992,"3","362","0","181","0","543"
"Fremont",1992,"4","374","0","165","4","543"
"Fremont",1992,"5","390","2","161","3","556"
"Fremont",1992,"6","429","0","172","0","601"
"Fremont",1992,"7","434","0","184","3","621"
"Fremont",1992,"8","427","0","165","1","593"
"Fremont",1992,"9","499","0","190","1","690"
"Fremont",1992,"10","469","3","172","3","647"
"Fremont",1992,"11","465","0","186","3","654"
"Fremont",1992,"12","499","0","170","0","669"
"Fremont",1992,"13","488","4","174","0","666"
"Fremont",1992,"14","465","0","140","0","605"
"Fremont",1992,"15","445","0","118","3","566"
"Fremont",1992,"16","428","2","114","1","545"
"Fremont",1992,"17","428","0","120","0","548"
"Fremont",1992,"18 to 20","893","3","334","2","1232"
"Fremont",1992,"21 to 24","966","4","415","10","1395"
"Fremont",1992,"25 & over","17885","19","2952","46","20902"
"Fremont",1992,"Total","27349","42","6678","84","34153"
"Big Horn",2002,"0","123","0","1","0","124"
"Big Horn",2002,"1","134","0","1","1","136"
"Big Horn",2002,"2","157","0","0","0","157"
"Big Horn",2002,"3","145","0","1","0","146"
"Big Horn",2002,"4","148","1","1","0","150"
"Big Horn",2002,"5","137","2","1","0","140"
"Big Horn",2002,"6","158","0","2","2","162"
"Big Horn",2002,"7","166","0","0","0","166"
"Big Horn",2002,"8","161","0","2","0","163"
"Big Horn",2002,"9","159","0","2","0","161"
"Big Horn",2002,"10","184","0","5","0","189"
"Big Horn",2002,"11","198","1","2","0","201"
"Big Horn",2002,"12","188","0","4","0","192"
"Big Horn",2002,"13","172","0","3","2","177"
"Big Horn",2002,"14","210","1","4","1","216"
"Big Horn",2002,"15","205","1","1","1","208"
"Big Horn",2002,"16","185","1","2","1","189"
"Big Horn",2002,"17","179","2","2","2","185"
"Big Horn",2002,"18 to 20","458","2","5","1","466"
"Big Horn",2002,"21 to 24","369","1","5","0","375"
"Big Horn",2002,"25 & over","7171","6","57","20","7254"
"Big Horn",2002,"Total","11007","18","101","31","11157"
"Sublette",1995,"0","63","0","0","0","63"
"Sublette",1995,"1","73","0","2","2","77"
"Sublette",1995,"2","67","0","0","0","67"
"Sublette",1995,"3","72","0","0","0","72"
"Sublette",1995,"4","74","0","0","0","74"
"Sublette",1995,"5","70","0","2","0","72"
"Sublette",1995,"6","76","0","0","0","76"
"Sublette",1995,"7","76","0","0","0","76"
"Sublette",1995,"8","77","0","2","0","79"
"Sublette",1995,"9","82","0","0","0","82"
"Sublette",1995,"10","86","0","5","0","91"
"Sublette",1995,"11","104","0","0","0","104"
"Sublette",1995,"12","97","0","0","0","97"
"Sublette",1995,"13","106","0","0","0","106"
"Sublette",1995,"14","93","0","0","0","93"
"Sublette",1995,"15","96","0","0","0","96"
"Sublette",1995,"16","92","0","0","0","92"
"Sublette",1995,"17","83","0","0","0","83"
"Sublette",1995,"18 to 20","159","0","0","0","159"
"Sublette",1995,"21 to 24","190","0","2","0","192"
"Sublette",1995,"25 & over","3642","2","18","2","3664"
"Sublette",1995,"Total","5478","2","31","4","5515"
"Platte",1994,"0","102","0","0","0","102"
"Platte",1994,"1","100","0","1","0","101"
"Platte",1994,"2","95","0","0","0","95"
"Platte",1994,"3","99","0","0","0","99"
"Platte",1994,"4","112","0","1","0","113"
"Platte",1994,"5","125","1","1","1","128"
"Platte",1994,"6","111","0","0","0","111"
"Platte",1994,"7","118","0","0","0","118"
"Platte",1994,"8","131","0","0","0","131"
"Platte",1994,"9","123","0","0","0","123"
"Platte",1994,"10","142","1","0","0","143"
"Platte",1994,"11","150","0","1","0","151"
"Platte",1994,"12","152","0","0","0","152"
"Platte",1994,"13","150","0","0","0","150"
"Platte",1994,"14","151","0","0","0","151"
"Platte",1994,"15","159","0","0","0","159"
"Platte",1994,"16","144","0","0","0","144"
"Platte",1994,"17","143","0","0","0","143"
"Platte",1994,"18 to 20","250","0","0","1","251"
"Platte",1994,"21 to 24","293","0","0","0","293"
"Platte",1994,"25 & over","5520","0","10","1","5531"
"Platte",1994,"Total","8370","2","14","3","8389"
"Campbell",1997,"0","457","0","4","2","463"
"Campbell",1997,"1","490","1","9","4","504"
"Campbell",1997,"2","505","2","3","0","510"
"Campbell",1997,"3","461","0","6","0","467"
"Campbell",1997,"4","496","2","7","0","505"
"Campbell",1997,"5","511","0","11","0","522"
"Campbell",1997,"6","542","0","6","1","549"
"Campbell",1997,"7","548","0","9","0","557"
"Campbell",1997,"8","544","5","5","1","555"
"Campbell",1997,"9","571","0","10","8","589"
"Campbell",1997,"10","571","6","10","5","592"
"Campbell",1997,"11","591","0","8","0","599"
"Campbell",1997,"12","660","0","14","8","682"
"Campbell",1997,"13","651","0","12","3","666"
"Campbell",1997,"14","675","0","9","0","684"
"Campbell",1997,"15","709","1","6","6","722"
"Campbell",1997,"16","676","3","10","1","690"
"Campbell",1997,"17","647","1","15","3","666"
"Campbell",1997,"18 to 20","1306","2","13","0","1321"
"Campbell",1997,"21 to 24","1502","3","22","14","1541"
"Campbell",1997,"25 & over","18473","20","164","57","18714"
"Campbell",1997,"Total","31586","46","353","113","32098"
"Park",1993,"0","286","0","1","2","289"
"Park",1993,"1","309","0","7","0","316"
"Park",1993,"2","316","0","2","2","320"
"Park",1993,"3","334","0","0","0","334"
"Park",1993,"4","330","0","2","3","335"
"Park",1993,"5","325","1","2","5","333"
"Park",1993,"6","338","0","0","0","338"
"Park",1993,"7","358","0","3","0","361"
"Park",1993,"8","379","0","2","0","381"
"Park",1993,"9","384","0","2","0","386"
"Park",1993,"10","394","0","7","0","401"
"Park",1993,"11","417","0","0","3","420"
"Park",1993,"12","426","0","4","3","433"
"Park",1993,"13","413","1","3","2","419"
"Park",1993,"14","392","1","0","2","395"
"Park",1993,"15","393","1","3","0","397"
"Park",1993,"16","378","0","3","1","382"
"Park",1993,"17","372","0","1","0","373"
"Park",1993,"18 to 20","1258","0","14","15","1287"
"Park",1993,"21 to 24","960","0","2","16","978"
"Park",1993,"25 & over","15324","8","67","54","15453"
"Park",1993,"Total","24086","12","125","108","24331"
"Goshen",2006,"0","122","3","2","0","127"
"Goshen",2006,"1","122","2","2","2","128"
"Goshen",2006,"2","132","4","0","1","137"
"Goshen",2006,"3","175","3","1","0","179"
"Goshen",2006,"4","118","1","0","1","120"
"Goshen",2006,"5","122","1","1","0","124"
"Goshen",2006,"6","149","1","3","2","155"
"Goshen",2006,"7","112","1","3","1","117"
"Goshen",2006,"8","142","2","1","0","145"
"Goshen",2006,"9","128","1","3","1","133"
"Goshen",2006,"10","137","2","1","1","141"
"Goshen",2006,"11","129","1","1","0","131"
"Goshen",2006,"12","190","0","6","1","197"
"Goshen",2006,"13","155","2","2","2","161"
"Goshen",2006,"14","172","1","3","2","178"
"Goshen",2006,"15","173","3","2","0","178"
"Goshen",2006,"16","204","3","2","0","209"
"Goshen",2006,"17","142","1","3","0","146"
"Goshen",2006,"18 to 20","603","11","8","3","625"
"Goshen",2006,"21 to 24","569","8","7","2","586"
"Goshen",2006,"25 & over","8487","35","72","27","8621"
"Goshen",2006,"Total","12283","86","123","46","12538"
"Niobrara",2008,"0","19","1","0","0","20"
"Niobrara",2008,"1","30","0","0","0","30"
"Niobrara",2008,"2","21","0","0","0","21"
"Niobrara",2008,"3","16","0","0","0","16"
"Niobrara",2008,"4","17","0","1","0","18"
"Niobrara",2008,"5","30","0","0","0","30"
"Niobrara",2008,"6","17","0","0","0","17"
"Niobrara",2008,"7","40","0","0","0","40"
"Niobrara",2008,"8","13","0","0","0","13"
"Niobrara",2008,"9","32","0","0","0","32"
"Niobrara",2008,"10","26","1","0","0","27"
"Niobrara",2008,"11","45","0","0","0","45"
"Niobrara",2008,"12","21","2","0","0","23"
"Niobrara",2008,"13","29","0","0","0","29"
"Niobrara",2008,"14","23","0","0","1","24"
"Niobrara",2008,"15","32","0","0","0","32"
"Niobrara",2008,"16","26","0","0","0","26"
"Niobrara",2008,"17","53","0","0","1","54"
"Niobrara",2008,"18 to 20","48","0","0","0","48"
"Niobrara",2008,"21 to 24","87","1","3","0","91"
"Niobrara",2008,"25 & over","1801","7","16","7","1831"
"Niobrara",2008,"Total","2426","12","20","9","2467"
"Big Horn",2015,"0","131","1","5","0","137"
"Big Horn",2015,"1","145","1","0","0","146"
"Big Horn",2015,"2","145","3","4","0","152"
"Big Horn",2015,"3","153","2","1","0","156"
"Big Horn",2015,"4","169","0","2","3","174"
"Big Horn",2015,"5","142","5","5","0","152"
"Big Horn",2015,"6","161","1","2","0","164"
"Big Horn",2015,"7","168","1","1","0","170"
"Big Horn",2015,"8","171","2","1","0","174"
"Big Horn",2015,"9","177","1","2","2","182"
"Big Horn",2015,"10","200","2","1","0","203"
"Big Horn",2015,"11","166","3","0","3","172"
"Big Horn",2015,"12","166","1","2","2","171"
"Big Horn",2015,"13","177","5","0","0","182"
"Big Horn",2015,"14","159","2","3","2","166"
"Big Horn",2015,"15","191","1","4","2","198"
"Big Horn",2015,"16","176","3","1","0","180"
"Big Horn",2015,"17","192","1","1","2","196"
"Big Horn",2015,"18 to 20","410","5","4","4","423"
"Big Horn",2015,"21 to 24","441","6","12","4","463"
"Big Horn",2015,"25 & over","7783","82","130","35","8030"
"Big Horn",2015,"Total","11623","128","181","59","11991"
"Campbell",2013,"0","677","13","37","7","734"
"Campbell",2013,"1","736","16","15","8","775"
"Campbell",2013,"2","681","13","24","4","722"
"Campbell",2013,"3","846","8","16","9","879"
"Campbell",2013,"4","765","6","20","4","795"
"Campbell",2013,"5","838","10","13","1","862"
"Campbell",2013,"6","797","11","21","2","831"
"Campbell",2013,"7","755","5","14","4","778"
"Campbell",2013,"8","732","5","14","4","755"
"Campbell",2013,"9","748","9","12","2","771"
"Campbell",2013,"10","673","8","18","7","706"
"Campbell",2013,"11","650","11","13","2","676"
"Campbell",2013,"12","685","10","11","5","711"
"Campbell",2013,"13","708","8","21","8","745"
"Campbell",2013,"14","671","4","12","6","693"
"Campbell",2013,"15","690","9","15","2","716"
"Campbell",2013,"16","627","7","16","2","652"
"Campbell",2013,"17","633","8","9","5","655"
"Campbell",2013,"18 to 20","1562","56","55","11","1684"
"Campbell",2013,"21 to 24","2636","53","56","27","2772"
"Campbell",2013,"25 & over","29187","323","456","238","30204"
"Campbell",2013,"Total","46297","593","868","358","48116"
"Converse",2015,"0","216","5","4","0","225"
"Converse",2015,"1","214","7","6","0","227"
"Converse",2015,"2","182","4","7","1","194"
"Converse",2015,"3","203","6","5","0","214"
"Converse",2015,"4","170","2","1","0","173"
"Converse",2015,"5","195","4","3","1","203"
"Converse",2015,"6","212","5","3","1","221"
"Converse",2015,"7","180","3","3","0","186"
"Converse",2015,"8","206","2","3","2","213"
"Converse",2015,"9","208","6","5","1","220"
"Converse",2015,"10","219","3","4","2","228"
"Converse",2015,"11","182","3","4","0","189"
"Converse",2015,"12","181","1","3","2","187"
"Converse",2015,"13","196","6","7","1","210"
"Converse",2015,"14","187","2","0","2","191"
"Converse",2015,"15","204","2","1","5","212"
"Converse",2015,"16","208","6","3","1","218"
"Converse",2015,"17","186","1","3","0","190"
"Converse",2015,"18 to 20","413","8","7","1","429"
"Converse",2015,"21 to 24","641","9","10","4","664"
"Converse",2015,"25 & over","9255","94","115","63","9527"
"Converse",2015,"Total","13858","179","197","87","14321"
"Big Horn",1995,"0","150","0","0","0","150"
"Big Horn",1995,"1","146","0","2","0","148"
"Big Horn",1995,"2","162","0","0","0","162"
"Big Horn",1995,"3","150","0","0","0","150"
"Big Horn",1995,"4","156","0","3","0","159"
"Big Horn",1995,"5","161","0","5","2","168"
"Big Horn",1995,"6","166","0","0","0","166"
"Big Horn",1995,"7","167","0","0","0","167"
"Big Horn",1995,"8","177","0","0","0","177"
"Big Horn",1995,"9","206","0","0","0","206"
"Big Horn",1995,"10","197","0","4","1","202"
"Big Horn",1995,"11","190","0","1","0","191"
"Big Horn",1995,"12","234","0","2","0","236"
"Big Horn",1995,"13","218","0","0","0","218"
"Big Horn",1995,"14","217","0","0","2","219"
"Big Horn",1995,"15","200","0","3","0","203"
"Big Horn",1995,"16","217","0","0","0","217"
"Big Horn",1995,"17","212","0","2","2","216"
"Big Horn",1995,"18 to 20","386","0","6","0","392"
"Big Horn",1995,"21 to 24","399","0","0","0","399"
"Big Horn",1995,"25 & over","7039","0","32","11","7082"
"Big Horn",1995,"Total","11150","0","60","18","11228"
"Park",1990,"0","318","0","1","1","320"
"Park",1990,"1","335","0","7","0","342"
"Park",1990,"2","319","0","1","2","322"
"Park",1990,"3","347","0","0","0","347"
"Park",1990,"4","370","0","2","1","373"
"Park",1990,"5","381","1","2","5","389"
"Park",1990,"6","378","0","0","1","379"
"Park",1990,"7","391","0","4","1","396"
"Park",1990,"8","384","0","2","1","387"
"Park",1990,"9","392","0","2","1","395"
"Park",1990,"10","392","0","8","0","400"
"Park",1990,"11","383","0","0","5","388"
"Park",1990,"12","380","0","4","1","385"
"Park",1990,"13","346","1","1","1","349"
"Park",1990,"14","341","1","0","1","343"
"Park",1990,"15","338","1","4","0","343"
"Park",1990,"16","335","0","7","3","345"
"Park",1990,"17","331","0","1","0","332"
"Park",1990,"18 to 20","1152","0","12","9","1173"
"Park",1990,"21 to 24","864","0","2","15","881"
"Park",1990,"25 & over","14479","8","59","55","14601"
"Park",1990,"Total","22956","12","119","103","23190"
"Crook",2000,"0","60","0","1","0","61"
"Crook",2000,"1","63","0","2","0","65"
"Crook",2000,"2","51","0","1","0","52"
"Crook",2000,"3","57","0","1","0","58"
"Crook",2000,"4","66","0","2","1","69"
"Crook",2000,"5","65","0","2","0","67"
"Crook",2000,"6","76","0","2","0","78"
"Crook",2000,"7","76","0","0","0","76"
"Crook",2000,"8","86","0","2","1","89"
"Crook",2000,"9","81","0","0","0","81"
"Crook",2000,"10","83","1","1","0","85"
"Crook",2000,"11","96","0","3","0","99"
"Crook",2000,"12","92","0","1","0","93"
"Crook",2000,"13","119","0","0","0","119"
"Crook",2000,"14","109","0","1","0","110"
"Crook",2000,"15","123","0","5","0","128"
"Crook",2000,"16","119","0","1","0","120"
"Crook",2000,"17","136","0","1","0","137"
"Crook",2000,"18 to 20","205","1","3","0","209"
"Crook",2000,"21 to 24","181","0","3","0","184"
"Crook",2000,"25 & over","3883","2","34","3","3922"
"Crook",2000,"Total","5827","4","66","5","5902"
"Teton",1994,"0","186","0","2","2","190"
"Teton",1994,"1","183","2","0","2","187"
"Teton",1994,"2","176","0","3","0","179"
"Teton",1994,"3","186","0","0","1","187"
"Teton",1994,"4","175","0","3","0","178"
"Teton",1994,"5","168","0","3","0","171"
"Teton",1994,"6","156","0","0","0","156"
"Teton",1994,"7","167","4","2","0","173"
"Teton",1994,"8","178","0","0","3","181"
"Teton",1994,"9","187","1","0","0","188"
"Teton",1994,"10","191","1","2","0","194"
"Teton",1994,"11","185","0","0","0","185"
"Teton",1994,"12","184","0","0","0","184"
"Teton",1994,"13","199","0","0","0","199"
"Teton",1994,"14","187","0","3","3","193"
"Teton",1994,"15","159","1","3","1","164"
"Teton",1994,"16","169","0","1","0","170"
"Teton",1994,"17","160","0","0","0","160"
"Teton",1994,"18 to 20","390","1","4","0","395"
"Teton",1994,"21 to 24","839","2","5","8","854"
"Teton",1994,"25 & over","9732","8","56","36","9832"
"Teton",1994,"Total","14157","20","87","56","14320"
"Platte",1997,"0","103","0","0","0","103"
"Platte",1997,"1","99","0","1","0","100"
"Platte",1997,"2","87","0","0","0","87"
"Platte",1997,"3","97","0","0","0","97"
"Platte",1997,"4","95","0","1","0","96"
"Platte",1997,"5","122","2","1","1","126"
"Platte",1997,"6","108","0","0","0","108"
"Platte",1997,"7","128","0","0","0","128"
"Platte",1997,"8","130","0","0","0","130"
"Platte",1997,"9","116","0","0","0","116"
"Platte",1997,"10","148","2","0","0","150"
"Platte",1997,"11","142","0","1","0","143"
"Platte",1997,"12","156","0","0","0","156"
"Platte",1997,"13","153","0","0","0","153"
"Platte",1997,"14","146","0","0","0","146"
"Platte",1997,"15","171","0","0","0","171"
"Platte",1997,"16","162","0","0","0","162"
"Platte",1997,"17","165","0","0","0","165"
"Platte",1997,"18 to 20","278","0","0","2","280"
"Platte",1997,"21 to 24","291","0","0","0","291"
"Platte",1997,"25 & over","5818","0","10","1","5829"
"Platte",1997,"Total","8715","4","14","4","8737"
"Fremont",2002,"0","267","2","177","2","448"
"Fremont",2002,"1","267","1","203","0","471"
"Fremont",2002,"2","316","3","154","1","474"
"Fremont",2002,"3","321","3","200","1","525"
"Fremont",2002,"4","308","3","163","1","475"
"Fremont",2002,"5","299","2","117","0","418"
"Fremont",2002,"6","302","2","165","2","471"
"Fremont",2002,"7","315","2","152","2","471"
"Fremont",2002,"8","373","3","183","1","560"
"Fremont",2002,"9","329","4","160","2","495"
"Fremont",2002,"10","349","1","184","1","535"
"Fremont",2002,"11","378","2","196","4","580"
"Fremont",2002,"12","369","4","157","1","531"
"Fremont",2002,"13","383","2","223","3","611"
"Fremont",2002,"14","376","0","154","3","533"
"Fremont",2002,"15","447","1","170","1","619"
"Fremont",2002,"16","461","2","170","2","635"
"Fremont",2002,"17","472","1","147","1","621"
"Fremont",2002,"18 to 20","1146","6","400","8","1560"
"Fremont",2002,"21 to 24","1185","5","485","16","1691"
"Fremont",2002,"25 & over","19594","39","3567","91","23291"
"Fremont",2002,"Total","28257","88","7527","143","36015"
"Lincoln",1995,"0","198","0","2","0","200"
"Lincoln",1995,"1","216","0","3","2","221"
"Lincoln",1995,"2","216","0","1","0","217"
"Lincoln",1995,"3","209","0","0","0","209"
"Lincoln",1995,"4","211","0","0","0","211"
"Lincoln",1995,"5","232","1","0","0","233"
"Lincoln",1995,"6","248","0","0","1","249"
"Lincoln",1995,"7","259","0","0","0","259"
"Lincoln",1995,"8","269","0","3","0","272"
"Lincoln",1995,"9","299","0","2","0","301"
"Lincoln",1995,"10","277","1","7","2","287"
"Lincoln",1995,"11","325","0","0","0","325"
"Lincoln",1995,"12","312","0","1","0","313"
"Lincoln",1995,"13","338","0","3","0","341"
"Lincoln",1995,"14","310","0","0","0","310"
"Lincoln",1995,"15","330","2","3","0","335"
"Lincoln",1995,"16","310","0","1","0","311"
"Lincoln",1995,"17","303","0","0","0","303"
"Lincoln",1995,"18 to 20","500","1","6","0","507"
"Lincoln",1995,"21 to 24","450","0","0","0","450"
"Lincoln",1995,"25 & over","8167","1","28","23","8219"
"Lincoln",1995,"Total","13979","6","60","28","14073"
"Carbon",2016,"0","180","4","8","2","194"
"Carbon",2016,"1","205","8","7","2","222"
"Carbon",2016,"2","164","3","1","1","169"
"Carbon",2016,"3","193","4","12","0","209"
"Carbon",2016,"4","195","3","2","1","201"
"Carbon",2016,"5","228","4","5","1","238"
"Carbon",2016,"6","208","5","5","1","219"
"Carbon",2016,"7","216","1","2","2","221"
"Carbon",2016,"8","210","7","2","2","221"
"Carbon",2016,"9","207","5","3","4","219"
"Carbon",2016,"10","212","5","3","1","221"
"Carbon",2016,"11","181","2","3","4","190"
"Carbon",2016,"12","198","6","0","1","205"
"Carbon",2016,"13","201","2","1","1","205"
"Carbon",2016,"14","175","5","5","0","185"
"Carbon",2016,"15","186","0","6","3","195"
"Carbon",2016,"16","192","5","1","2","200"
"Carbon",2016,"17","194","2","6","5","207"
"Carbon",2016,"18 to 20","451","10","6","5","472"
"Carbon",2016,"21 to 24","690","17","17","13","737"
"Carbon",2016,"25 & over","10194","170","203","121","10688"
"Carbon",2016,"Total","14880","268","298","172","15618"
"Albany",1999,"0","321","5","3","8","337"
"Albany",1999,"1","305","30","4","9","348"
"Albany",1999,"2","322","4","5","8","339"
"Albany",1999,"3","305","0","2","4","311"
"Albany",1999,"4","296","13","4","11","324"
"Albany",1999,"5","320","8","4","2","334"
"Albany",1999,"6","273","7","9","3","292"
"Albany",1999,"7","324","5","6","6","341"
"Albany",1999,"8","295","3","3","3","304"
"Albany",1999,"9","325","9","5","10","349"
"Albany",1999,"10","313","5","6","8","332"
"Albany",1999,"11","283","9","4","6","302"
"Albany",1999,"12","307","12","8","8","335"
"Albany",1999,"13","333","11","8","8","360"
"Albany",1999,"14","334","0","8","4","346"
"Albany",1999,"15","342","6","5","5","358"
"Albany",1999,"16","356","1","9","3","369"
"Albany",1999,"17","374","4","2","4","384"
"Albany",1999,"18 to 20","4041","66","45","38","4190"
"Albany",1999,"21 to 24","4681","78","45","83","4887"
"Albany",1999,"25 & over","16408","128","146","368","17050"
"Albany",1999,"Total","30858","404","331","599","32192"
"Natrona",1992,"0","891","11","12","1","915"
"Natrona",1992,"1","886","6","11","6","909"
"Natrona",1992,"2","884","15","11","1","911"
"Natrona",1992,"3","896","14","11","10","931"
"Natrona",1992,"4","928","17","8","4","957"
"Natrona",1992,"5","949","12","10","5","976"
"Natrona",1992,"6","979","10","7","1","997"
"Natrona",1992,"7","1048","18","9","9","1084"
"Natrona",1992,"8","1011","16","9","3","1039"
"Natrona",1992,"9","1073","10","11","10","1104"
"Natrona",1992,"10","1137","20","11","6","1174"
"Natrona",1992,"11","1093","11","7","5","1116"
"Natrona",1992,"12","1067","17","15","7","1106"
"Natrona",1992,"13","999","7","14","8","1028"
"Natrona",1992,"14","962","8","9","4","983"
"Natrona",1992,"15","997","11","8","8","1024"
"Natrona",1992,"16","893","8","3","5","909"
"Natrona",1992,"17","959","11","6","4","980"
"Natrona",1992,"18 to 20","2697","62","25","15","2799"
"Natrona",1992,"21 to 24","2763","25","31","13","2832"
"Natrona",1992,"25 & over","38630","223","300","160","39313"
"Natrona",1992,"Total","61742","532","528","285","63087"
"Natrona",2015,"0","1121","39","28","18","1206"
"Natrona",2015,"1","1117","36","46","18","1217"
"Natrona",2015,"2","1072","36","37","8","1153"
"Natrona",2015,"3","1033","37","26","14","1110"
"Natrona",2015,"4","1037","35","35","26","1133"
"Natrona",2015,"5","1103","36","18","21","1178"
"Natrona",2015,"6","1018","24","16","30","1088"
"Natrona",2015,"7","1120","33","25","20","1198"
"Natrona",2015,"8","1137","24","21","18","1200"
"Natrona",2015,"9","1072","28","25","8","1133"
"Natrona",2015,"10","1025","26","22","6","1079"
"Natrona",2015,"11","1046","18","25","15","1104"
"Natrona",2015,"12","1011","26","18","13","1068"
"Natrona",2015,"13","950","19","14","7","990"
"Natrona",2015,"14","995","21","30","13","1059"
"Natrona",2015,"15","944","22","18","6","990"
"Natrona",2015,"16","931","24","22","19","996"
"Natrona",2015,"17","918","39","17","7","981"
"Natrona",2015,"18 to 20","2634","82","58","42","2816"
"Natrona",2015,"21 to 24","4200","98","110","46","4454"
"Natrona",2015,"25 & over","52902","798","759","579","55038"
"Natrona",2015,"Total","78386","1501","1370","934","82191"
