Year,Age Range,County,White,Black,American Indian,Asian,Total
1993,18-20,Albany County,3954,59,24,54,4091
1993,18-20,Big Horn County,346,0,6,0,352
1993,18-20,Campbell County,1105,1,12,0,1118
1993,18-20,Carbon County,557,5,11,4,577
1993,18-20,Converse County,367,0,6,0,373
1993,18-20,Crook County,172,0,2,0,174
1993,18-20,Fremont County,935,3,348,2,1288
1993,18-20,Goshen County,569,5,2,3,579
1993,18-20,Hot Springs County,131,1,2,0,134
1993,18-20,Johnson County,198,0,0,0,198
1993,18-20,Laramie County,3064,142,44,42,3292
1993,18-20,Lincoln County,448,1,5,0,454
1993,18-20,Natrona County,2762,57,27,15,2861
1993,18-20,Niobrara County,70,2,0,0,72
1993,18-20,Park County,1258,0,14,15,1287
1993,18-20,Platte County,246,0,0,2,248
1993,18-20,Sheridan County,950,14,11,0,975
1993,18-20,Sublette County,149,0,0,0,149
1993,18-20,Sweetwater County,1724,20,15,13,1772
1993,18-20,Teton County,373,1,6,0,380
1993,18-20,Uinta County,726,0,2,7,735
1993,18-20,Washakie County,267,1,1,0,269
1993,18-20,Weston County,210,0,13,0,223
1990,18-20,Albany County,3920,57,19,56,4052
1990,18-20,Big Horn County,316,0,5,0,321
1990,18-20,Campbell County,1001,1,14,0,1016
1990,18-20,Carbon County,542,5,7,2,556
1990,18-20,Converse County,357,0,6,0,363
1990,18-20,Crook County,152,0,2,0,154
1990,18-20,Fremont County,867,3,321,5,1196
1990,18-20,Goshen County,522,6,3,4,535
1990,18-20,Hot Springs County,127,1,3,0,131
1990,18-20,Johnson County,210,0,0,0,210
1990,18-20,Laramie County,2953,126,35,48,3162
1990,18-20,Lincoln County,405,1,7,0,413
1990,18-20,Natrona County,2487,51,24,11,2573
1990,18-20,Niobrara County,64,2,0,0,66
1990,18-20,Park County,1152,0,12,9,1173
1990,18-20,Platte County,239,0,0,2,241
1990,18-20,Sheridan County,905,8,10,0,923
1990,18-20,Sublette County,143,0,0,0,143
1990,18-20,Sweetwater County,1526,17,10,11,1564
1990,18-20,Teton County,310,1,8,0,319
1990,18-20,Uinta County,647,0,3,4,654
1990,18-20,Washakie County,259,1,1,0,261
1990,18-20,Weston County,192,0,12,0,204
2009,18-20,Albany County,4495,91,46,99,4731
2009,18-20,Big Horn County,336,9,6,2,353
2009,18-20,Campbell County,1717,32,50,27,1826
2009,18-20,Carbon County,473,7,6,4,490
2009,18-20,Converse County,452,3,2,1,458
2009,18-20,Crook County,221,1,1,0,223
2009,18-20,Fremont County,1092,6,500,7,1605
2009,18-20,Goshen County,637,13,9,7,666
2009,18-20,Hot Springs County,117,0,5,1,123
2009,18-20,Johnson County,211,0,5,2,218
2009,18-20,Laramie County,3348,208,51,69,3676
2009,18-20,Lincoln County,510,2,3,1,516
2009,18-20,Natrona County,3028,62,55,32,3177
2009,18-20,Niobrara County,53,0,0,0,53
2009,18-20,Park County,1263,18,22,29,1332
2009,18-20,Platte County,233,1,2,4,240
2009,18-20,Sheridan County,1099,15,28,21,1163
2009,18-20,Sublette County,280,3,8,4,295
2009,18-20,Sweetwater County,1784,39,40,21,1884
2009,18-20,Teton County,426,7,6,11,450
2009,18-20,Uinta County,761,8,18,3,790
2009,18-20,Washakie County,240,2,6,2,250
2009,18-20,Weston County,234,2,6,1,243
2015,18-20,Albany County,3756,65,25,195,4041
2015,18-20,Big Horn County,397,5,4,4,410
2015,18-20,Campbell County,1496,29,42,7,1574
2015,18-20,Carbon County,419,5,10,5,439
2015,18-20,Converse County,401,10,7,1,419
2015,18-20,Crook County,213,1,3,0,217
2015,18-20,Fremont County,907,11,437,11,1366
2015,18-20,Goshen County,549,17,9,4,579
2015,18-20,Hot Springs County,117,3,2,3,125
2015,18-20,Johnson County,244,6,3,3,256
2015,18-20,Laramie County,3070,221,41,61,3393
2015,18-20,Lincoln County,533,4,12,5,554
2015,18-20,Natrona County,2607,85,57,31,2780
2015,18-20,Niobrara County,67,3,0,1,71
2015,18-20,Park County,1020,18,29,34,1101
2015,18-20,Platte County,236,4,2,4,246
2015,18-20,Sheridan County,1023,24,32,15,1094
2015,18-20,Sublette County,244,4,10,1,259
2015,18-20,Sweetwater County,1548,36,38,31,1653
2015,18-20,Teton County,435,10,9,11,465
2015,18-20,Uinta County,641,10,9,6,666
2015,18-20,Washakie County,229,7,10,6,252
2015,18-20,Weston County,200,4,7,2,213
2008,18-20,Albany County,4431,78,36,94,4639
2008,18-20,Big Horn County,356,5,6,1,368
2008,18-20,Campbell County,1626,26,42,17,1711
2008,18-20,Carbon County,458,6,6,3,473
2008,18-20,Converse County,430,2,3,1,436
2008,18-20,Crook County,198,1,1,0,200
2008,18-20,Fremont County,1041,3,472,4,1520
2008,18-20,Goshen County,657,13,8,6,684
2008,18-20,Hot Springs County,139,0,5,1,145
2008,18-20,Johnson County,229,0,5,1,235
2008,18-20,Laramie County,3223,181,53,55,3512
2008,18-20,Lincoln County,499,2,3,1,505
2008,18-20,Natrona County,2942,66,48,33,3089
2008,18-20,Niobrara County,48,0,0,0,48
2008,18-20,Park County,1238,16,17,25,1296
2008,18-20,Platte County,256,1,2,3,262
2008,18-20,Sheridan County,1051,15,23,16,1105
2008,18-20,Sublette County,262,3,7,3,275
2008,18-20,Sweetwater County,1676,32,30,21,1759
2008,18-20,Teton County,439,4,6,8,457
2008,18-20,Uinta County,791,9,21,3,824
2008,18-20,Washakie County,248,2,6,3,259
2008,18-20,Weston County,220,2,6,1,229
2001,18-20,Albany County,4287,62,46,69,4464
2001,18-20,Big Horn County,422,0,5,1,428
2001,18-20,Campbell County,1504,7,22,5,1538
2001,18-20,Carbon County,559,7,9,4,579
2001,18-20,Converse County,450,1,6,3,460
2001,18-20,Crook County,226,1,3,0,230
2001,18-20,Fremont County,1141,4,424,6,1575
2001,18-20,Goshen County,616,5,7,5,633
2001,18-20,Hot Springs County,152,0,5,1,158
2001,18-20,Johnson County,258,0,3,3,264
2001,18-20,Laramie County,3193,228,46,70,3537
2001,18-20,Lincoln County,588,1,5,3,597
2001,18-20,Natrona County,3074,46,45,23,3188
2001,18-20,Niobrara County,80,1,0,0,81
2001,18-20,Park County,1284,1,13,12,1310
2001,18-20,Platte County,293,3,4,2,302
2001,18-20,Sheridan County,1075,9,24,2,1110
2001,18-20,Sublette County,185,1,0,0,186
2001,18-20,Sweetwater County,1909,19,19,25,1972
2001,18-20,Teton County,537,1,3,4,545
2001,18-20,Uinta County,900,2,18,2,922
2001,18-20,Washakie County,295,2,3,0,300
2001,18-20,Weston County,262,0,14,0,276
1996,18-20,Albany County,4016,60,33,43,4152
1996,18-20,Big Horn County,396,0,6,0,402
1996,18-20,Campbell County,1263,3,13,0,1279
1996,18-20,Carbon County,571,8,13,3,595
1996,18-20,Converse County,393,0,6,0,399
1996,18-20,Crook County,203,0,3,0,206
1996,18-20,Fremont County,1051,2,364,2,1419
1996,18-20,Goshen County,627,6,4,5,642
1996,18-20,Hot Springs County,142,1,2,0,145
1996,18-20,Johnson County,211,0,0,0,211
1996,18-20,Laramie County,3127,146,42,49,3364
1996,18-20,Lincoln County,515,3,6,0,524
1996,18-20,Natrona County,3023,48,36,20,3127
1996,18-20,Niobrara County,76,1,0,0,77
1996,18-20,Park County,1369,0,14,13,1396
1996,18-20,Platte County,269,0,0,1,270
1996,18-20,Sheridan County,1021,12,13,0,1046
1996,18-20,Sublette County,158,0,0,0,158
1996,18-20,Sweetwater County,1825,15,15,22,1877
1996,18-20,Teton County,428,1,6,0,435
1996,18-20,Uinta County,815,0,4,5,824
1996,18-20,Washakie County,273,1,1,0,275
1996,18-20,Weston County,247,0,15,0,262
2010,18-20,Albany County,4374,85,33,113,4605
2010,18-20,Big Horn County,359,7,6,1,373
2010,18-20,Campbell County,1670,31,45,16,1762
2010,18-20,Carbon County,437,9,6,3,455
2010,18-20,Converse County,451,3,2,0,456
2010,18-20,Crook County,204,2,1,0,207
2010,18-20,Fremont County,1077,7,498,9,1591
2010,18-20,Goshen County,691,13,10,5,719
2010,18-20,Hot Springs County,115,1,4,1,121
2010,18-20,Johnson County,221,1,5,2,229
2010,18-20,Laramie County,3368,223,56,68,3715
2010,18-20,Lincoln County,505,2,4,1,512
2010,18-20,Natrona County,2992,70,61,29,3152
2010,18-20,Niobrara County,51,0,0,0,51
2010,18-20,Park County,1240,20,20,28,1308
2010,18-20,Platte County,237,1,2,4,244
2010,18-20,Sheridan County,1044,17,31,16,1108
2010,18-20,Sublette County,283,2,8,3,296
2010,18-20,Sweetwater County,1689,37,33,21,1780
2010,18-20,Teton County,432,10,6,9,457
2010,18-20,Uinta County,700,13,18,4,735
2010,18-20,Washakie County,235,4,6,2,247
2010,18-20,Weston County,200,3,5,1,209
2014,18-20,Albany County,3692,73,28,173,3966
2014,18-20,Big Horn County,400,13,5,6,424
2014,18-20,Campbell County,1481,47,42,9,1579
2014,18-20,Carbon County,423,19,16,5,463
2014,18-20,Converse County,438,10,6,3,457
2014,18-20,Crook County,227,10,3,5,245
2014,18-20,Fremont County,948,22,417,10,1397
2014,18-20,Goshen County,526,25,9,3,563
2014,18-20,Hot Springs County,112,5,4,2,123
2014,18-20,Johnson County,263,8,4,1,276
2014,18-20,Laramie County,3183,223,50,67,3523
2014,18-20,Lincoln County,596,25,13,5,639
2014,18-20,Natrona County,2649,99,55,29,2832
2014,18-20,Niobrara County,66,1,0,1,68
2014,18-20,Park County,1141,40,31,30,1242
2014,18-20,Platte County,240,5,3,6,254
2014,18-20,Sheridan County,988,26,32,19,1065
2014,18-20,Sublette County,278,11,11,3,303
2014,18-20,Sweetwater County,1573,54,33,33,1693
2014,18-20,Teton County,472,30,5,11,518
2014,18-20,Uinta County,683,19,14,6,722
2014,18-20,Washakie County,239,7,13,4,263
2014,18-20,Weston County,205,9,8,4,226
2017,18-20,Albany County,3493,80,22,203,3798
2017,18-20,Big Horn County,385,4,1,2,392
2017,18-20,Campbell County,1431,28,36,10,1505
2017,18-20,Carbon County,434,6,12,8,460
2017,18-20,Converse County,401,4,5,2,412
2017,18-20,Crook County,169,2,4,0,175
2017,18-20,Fremont County,924,11,444,12,1391
2017,18-20,Goshen County,590,13,6,4,613
2017,18-20,Hot Springs County,119,1,2,1,123
2017,18-20,Johnson County,216,1,3,1,221
2017,18-20,Laramie County,3056,203,56,48,3363
2017,18-20,Lincoln County,591,7,8,5,611
2017,18-20,Natrona County,2389,86,52,26,2553
2017,18-20,Niobrara County,72,3,1,0,76
2017,18-20,Park County,1060,26,27,33,1146
2017,18-20,Platte County,218,2,1,5,226
2017,18-20,Sheridan County,1023,27,29,14,1093
2017,18-20,Sublette County,259,5,8,2,274
2017,18-20,Sweetwater County,1534,34,38,29,1635
2017,18-20,Teton County,449,3,7,9,468
2017,18-20,Uinta County,665,11,13,6,695
2017,18-20,Washakie County,233,3,11,6,253
2017,18-20,Weston County,182,5,5,1,193
1999,18-20,Albany County,4041,66,45,38,4190
1999,18-20,Big Horn County,428,0,7,0,435
1999,18-20,Campbell County,1403,2,15,0,1420
1999,18-20,Carbon County,572,10,16,4,602
1999,18-20,Converse County,401,0,6,0,407
1999,18-20,Crook County,225,0,3,0,228
1999,18-20,Fremont County,1136,4,451,4,1595
1999,18-20,Goshen County,655,4,5,6,670
1999,18-20,Hot Springs County,156,1,3,0,160
1999,18-20,Johnson County,207,0,0,0,207
1999,18-20,Laramie County,3094,197,53,57,3401
1999,18-20,Lincoln County,553,2,7,0,562
1999,18-20,Natrona County,3200,44,42,24,3310
1999,18-20,Niobrara County,81,1,0,0,82
1999,18-20,Park County,1325,0,16,20,1361
1999,18-20,Platte County,286,0,0,1,287
1999,18-20,Sheridan County,1054,14,18,0,1086
1999,18-20,Sublette County,164,0,0,0,164
1999,18-20,Sweetwater County,1922,18,22,35,1997
1999,18-20,Teton County,494,1,6,0,501
1999,18-20,Uinta County,883,0,8,5,896
1999,18-20,Washakie County,278,0,1,0,279
1999,18-20,Weston County,264,0,16,0,280
2012,18-20,Albany County,3822,93,24,127,4066
2012,18-20,Big Horn County,381,18,5,2,406
2012,18-20,Campbell County,1573,58,60,11,1702
2012,18-20,Carbon County,460,13,11,6,490
2012,18-20,Converse County,470,12,6,2,490
2012,18-20,Crook County,205,4,3,0,212
2012,18-20,Fremont County,1028,20,477,7,1532
2012,18-20,Goshen County,632,21,11,5,669
2012,18-20,Hot Springs County,124,4,4,2,134
2012,18-20,Johnson County,232,16,6,3,257
2012,18-20,Laramie County,3298,244,59,73,3674
2012,18-20,Lincoln County,562,11,11,4,588
2012,18-20,Natrona County,2685,95,57,26,2863
2012,18-20,Niobrara County,64,0,0,1,65
2012,18-20,Park County,1203,56,27,27,1313
2012,18-20,Platte County,271,2,7,6,286
2012,18-20,Sheridan County,1075,31,44,14,1164
2012,18-20,Sublette County,298,10,10,2,320
2012,18-20,Sweetwater County,1657,44,42,31,1774
2012,18-20,Teton County,488,21,5,3,517
2012,18-20,Uinta County,736,20,14,4,774
2012,18-20,Washakie County,240,7,9,5,261
2012,18-20,Weston County,203,8,6,1,218
1998,18-20,Albany County,4070,73,42,36,4221
1998,18-20,Big Horn County,429,0,7,0,436
1998,18-20,Campbell County,1369,4,18,0,1391
1998,18-20,Carbon County,577,8,16,4,605
1998,18-20,Converse County,401,0,6,0,407
1998,18-20,Crook County,222,0,3,0,225
1998,18-20,Fremont County,1125,2,421,2,1550
1998,18-20,Goshen County,658,5,6,6,675
1998,18-20,Hot Springs County,158,1,4,0,163
1998,18-20,Johnson County,209,0,0,0,209
1998,18-20,Laramie County,3114,180,50,48,3392
1998,18-20,Lincoln County,541,4,6,0,551
1998,18-20,Natrona County,3194,56,41,21,3312
1998,18-20,Niobrara County,80,1,0,0,81
1998,18-20,Park County,1345,0,15,14,1374
1998,18-20,Platte County,287,0,0,1,288
1998,18-20,Sheridan County,1052,17,16,0,1085
1998,18-20,Sublette County,169,0,0,0,169
1998,18-20,Sweetwater County,1929,19,27,26,2001
1998,18-20,Teton County,474,1,6,0,481
1998,18-20,Uinta County,876,0,5,5,886
1998,18-20,Washakie County,284,1,1,0,286
1998,18-20,Weston County,266,0,15,0,281
2006,18-20,Albany County,4404,76,40,87,4607
2006,18-20,Big Horn County,351,6,4,1,362
2006,18-20,Campbell County,1566,21,34,17,1638
2006,18-20,Carbon County,493,6,5,5,509
2006,18-20,Converse County,470,2,3,0,475
2006,18-20,Crook County,224,0,1,0,225
2006,18-20,Fremont County,1041,5,447,7,1500
2006,18-20,Goshen County,603,11,8,3,625
2006,18-20,Hot Springs County,154,0,4,1,159
2006,18-20,Johnson County,215,0,3,2,220
2006,18-20,Laramie County,3275,186,59,68,3588
2006,18-20,Lincoln County,510,2,3,1,516
2006,18-20,Natrona County,2806,48,57,29,2940
2006,18-20,Niobrara County,50,0,0,0,50
2006,18-20,Park County,1208,12,16,20,1256
2006,18-20,Platte County,255,1,1,2,259
2006,18-20,Sheridan County,1025,13,24,14,1076
2006,18-20,Sublette County,221,2,7,3,233
2006,18-20,Sweetwater County,1751,33,29,23,1836
2006,18-20,Teton County,507,4,5,6,522
2006,18-20,Uinta County,772,7,19,3,801
2006,18-20,Washakie County,240,1,5,3,249
2006,18-20,Weston County,240,2,8,1,251
1995,18-20,Albany County,4042,67,28,45,4182
1995,18-20,Big Horn County,386,0,6,0,392
1995,18-20,Campbell County,1203,1,15,0,1219
1995,18-20,Carbon County,562,5,13,3,583
1995,18-20,Converse County,383,0,7,0,390
1995,18-20,Crook County,193,0,2,0,195
1995,18-20,Fremont County,1007,2,334,2,1345
1995,18-20,Goshen County,608,7,2,3,620
1995,18-20,Hot Springs County,136,1,3,0,140
1995,18-20,Johnson County,205,0,0,0,205
1995,18-20,Laramie County,3106,154,40,48,3348
1995,18-20,Lincoln County,500,1,6,0,507
1995,18-20,Natrona County,2955,51,23,17,3046
1995,18-20,Niobrara County,73,1,0,0,74
1995,18-20,Park County,1408,0,11,16,1435
1995,18-20,Platte County,263,0,0,2,265
1995,18-20,Sheridan County,993,11,11,0,1015
1995,18-20,Sublette County,159,0,0,0,159
1995,18-20,Sweetwater County,1838,18,14,17,1887
1995,18-20,Teton County,407,1,5,0,413
1995,18-20,Uinta County,789,0,4,6,799
1995,18-20,Washakie County,271,1,1,0,273
1995,18-20,Weston County,233,0,13,0,246
2011,18-20,Albany County,4129,77,34,107,4347
2011,18-20,Big Horn County,391,6,10,3,410
2011,18-20,Campbell County,1625,36,55,9,1725
2011,18-20,Carbon County,453,10,11,3,477
2011,18-20,Converse County,466,4,4,2,476
2011,18-20,Crook County,220,2,1,0,223
2011,18-20,Fremont County,1043,5,499,4,1551
2011,18-20,Goshen County,645,18,11,5,679
2011,18-20,Hot Springs County,122,3,2,2,129
2011,18-20,Johnson County,221,4,4,1,230
2011,18-20,Laramie County,3263,226,61,67,3617
2011,18-20,Lincoln County,559,6,12,1,578
2011,18-20,Natrona County,2829,67,59,31,2986
2011,18-20,Niobrara County,66,1,0,1,68
2011,18-20,Park County,1154,39,22,24,1239
2011,18-20,Platte County,243,3,5,5,256
2011,18-20,Sheridan County,1044,22,31,14,1111
2011,18-20,Sublette County,278,3,10,1,292
2011,18-20,Sweetwater County,1647,37,37,23,1744
2011,18-20,Teton County,439,11,10,2,462
2011,18-20,Uinta County,718,13,16,3,750
2011,18-20,Washakie County,233,2,11,3,249
2011,18-20,Weston County,198,2,4,1,205
2004,18-20,Albany County,4306,60,39,81,4486
2004,18-20,Big Horn County,377,2,7,1,387
2004,18-20,Campbell County,1612,15,29,10,1666
2004,18-20,Carbon County,560,8,9,5,582
2004,18-20,Converse County,465,1,4,4,474
2004,18-20,Crook County,235,1,1,0,237
2004,18-20,Fremont County,1128,7,414,7,1556
2004,18-20,Goshen County,606,7,7,7,627
2004,18-20,Hot Springs County,177,0,5,1,183
2004,18-20,Johnson County,249,0,3,4,256
2004,18-20,Laramie County,3547,250,67,55,3919
2004,18-20,Lincoln County,557,2,4,3,566
2004,18-20,Natrona County,2916,60,43,28,3047
2004,18-20,Niobrara County,68,1,0,0,69
2004,18-20,Park County,1237,4,15,18,1274
2004,18-20,Platte County,280,2,4,3,289
2004,18-20,Sheridan County,1091,10,26,8,1135
2004,18-20,Sublette County,226,2,1,1,230
2004,18-20,Sweetwater County,1797,32,23,27,1879
2004,18-20,Teton County,540,3,3,7,553
2004,18-20,Uinta County,849,4,21,2,876
2004,18-20,Washakie County,286,2,4,2,294
2004,18-20,Weston County,261,1,9,0,271
2003,18-20,Albany County,4363,60,41,79,4543
2003,18-20,Big Horn County,393,2,6,1,402
2003,18-20,Campbell County,1594,14,27,8,1643
2003,18-20,Carbon County,583,7,7,5,602
2003,18-20,Converse County,475,1,5,3,484
2003,18-20,Crook County,245,1,1,0,247
2003,18-20,Fremont County,1124,6,404,4,1538
2003,18-20,Goshen County,605,6,7,6,624
2003,18-20,Hot Springs County,163,0,5,1,169
2003,18-20,Johnson County,244,0,3,3,250
2003,18-20,Laramie County,3344,256,52,58,3710
2003,18-20,Lincoln County,595,2,4,3,604
2003,18-20,Natrona County,2928,49,54,27,3058
2003,18-20,Niobrara County,74,1,0,0,75
2003,18-20,Park County,1233,2,15,14,1264
2003,18-20,Platte County,307,2,4,2,315
2003,18-20,Sheridan County,1104,12,25,7,1148
2003,18-20,Sublette County,222,2,1,1,226
2003,18-20,Sweetwater County,1836,26,23,27,1912
2003,18-20,Teton County,559,2,3,7,571
2003,18-20,Uinta County,878,4,18,2,902
2003,18-20,Washakie County,278,2,4,2,286
2003,18-20,Weston County,276,0,10,0,286
1997,18-20,Albany County,3970,57,36,40,4103
1997,18-20,Big Horn County,404,0,5,0,409
1997,18-20,Campbell County,1306,2,13,0,1321
1997,18-20,Carbon County,569,6,14,3,592
1997,18-20,Converse County,400,0,6,0,406
1997,18-20,Crook County,214,0,3,0,217
1997,18-20,Fremont County,1083,4,383,4,1474
1997,18-20,Goshen County,650,6,2,5,663
1997,18-20,Hot Springs County,149,1,2,0,152
1997,18-20,Johnson County,206,0,0,0,206
1997,18-20,Laramie County,3134,156,45,48,3383
1997,18-20,Lincoln County,525,3,6,0,534
1997,18-20,Natrona County,3130,43,33,22,3228
1997,18-20,Niobrara County,79,1,0,0,80
1997,18-20,Park County,1390,0,16,16,1422
1997,18-20,Platte County,278,0,0,2,280
1997,18-20,Sheridan County,1040,13,14,0,1067
1997,18-20,Sublette County,161,0,0,0,161
1997,18-20,Sweetwater County,1884,15,16,24,1939
1997,18-20,Teton County,454,0,6,0,460
1997,18-20,Uinta County,838,0,4,5,847
1997,18-20,Washakie County,275,1,1,0,277
1997,18-20,Weston County,254,0,15,0,269
1994,18-20,Albany County,3982,57,25,44,4108
1994,18-20,Big Horn County,358,0,7,0,365
1994,18-20,Campbell County,1141,1,11,0,1153
1994,18-20,Carbon County,546,5,11,3,565
1994,18-20,Converse County,371,0,5,0,376
1994,18-20,Crook County,181,0,2,0,183
1994,18-20,Fremont County,972,2,333,2,1309
1994,18-20,Goshen County,576,6,4,3,589
1994,18-20,Hot Springs County,137,1,1,0,139
1994,18-20,Johnson County,200,0,0,0,200
1994,18-20,Laramie County,3085,135,43,47,3310
1994,18-20,Lincoln County,471,1,6,0,478
1994,18-20,Natrona County,2901,51,26,17,2995
1994,18-20,Niobrara County,69,1,0,0,70
1994,18-20,Park County,1337,0,12,12,1361
1994,18-20,Platte County,250,0,0,1,251
1994,18-20,Sheridan County,970,11,12,0,993
1994,18-20,Sublette County,153,0,0,0,153
1994,18-20,Sweetwater County,1774,17,12,16,1819
1994,18-20,Teton County,390,1,4,0,395
1994,18-20,Uinta County,760,0,4,6,770
1994,18-20,Washakie County,266,1,1,0,268
1994,18-20,Weston County,221,0,14,0,235
2013,18-20,Albany County,3773,88,19,149,4029
2013,18-20,Big Horn County,408,14,6,3,431
2013,18-20,Campbell County,1555,59,53,11,1678
2013,18-20,Carbon County,467,13,14,4,498
2013,18-20,Converse County,455,12,7,1,475
2013,18-20,Crook County,206,6,4,0,216
2013,18-20,Fremont County,986,28,451,11,1476
2013,18-20,Goshen County,574,19,12,4,609
2013,18-20,Hot Springs County,116,8,3,2,129
2013,18-20,Johnson County,257,10,6,1,274
2013,18-20,Laramie County,3235,271,66,71,3643
2013,18-20,Lincoln County,564,12,14,3,593
2013,18-20,Natrona County,2750,144,53,30,2977
2013,18-20,Niobrara County,66,3,0,1,70
2013,18-20,Park County,1134,56,27,26,1243
2013,18-20,Platte County,274,7,6,6,293
2013,18-20,Sheridan County,1068,38,36,16,1158
2013,18-20,Sublette County,290,9,9,3,311
2013,18-20,Sweetwater County,1631,62,40,30,1763
2013,18-20,Teton County,519,46,4,8,577
2013,18-20,Uinta County,730,23,16,4,773
2013,18-20,Washakie County,244,6,10,6,266
2013,18-20,Weston County,220,1,8,3,232
2016,18-20,Albany County,3507,68,23,210,3808
2016,18-20,Big Horn County,401,6,2,4,413
2016,18-20,Campbell County,1489,36,37,7,1569
2016,18-20,Carbon County,444,8,7,7,466
2016,18-20,Converse County,402,9,5,0,416
2016,18-20,Crook County,191,3,1,0,195
2016,18-20,Fremont County,927,12,447,12,1398
2016,18-20,Goshen County,576,15,8,4,603
2016,18-20,Hot Springs County,109,4,1,3,117
2016,18-20,Johnson County,209,6,3,2,220
2016,18-20,Laramie County,3137,204,56,58,3455
2016,18-20,Lincoln County,569,3,10,5,587
2016,18-20,Natrona County,2478,89,66,28,2661
2016,18-20,Niobrara County,64,4,1,1,70
2016,18-20,Park County,1044,23,29,35,1131
2016,18-20,Platte County,218,4,3,7,232
2016,18-20,Sheridan County,1022,23,35,13,1093
2016,18-20,Sublette County,250,4,8,1,263
2016,18-20,Sweetwater County,1552,32,37,30,1651
2016,18-20,Teton County,442,7,4,12,465
2016,18-20,Uinta County,648,8,13,6,675
2016,18-20,Washakie County,233,3,11,4,251
2016,18-20,Weston County,201,7,4,1,213
2005,18-20,Albany County,4330,64,38,76,4508
2005,18-20,Big Horn County,352,7,5,1,365
2005,18-20,Campbell County,1655,20,40,11,1726
2005,18-20,Carbon County,528,7,7,5,547
2005,18-20,Converse County,489,1,2,1,493
2005,18-20,Crook County,245,0,1,0,246
2005,18-20,Fremont County,1135,6,425,8,1574
2005,18-20,Goshen County,610,6,7,3,626
2005,18-20,Hot Springs County,161,0,4,1,166
2005,18-20,Johnson County,228,0,4,2,234
2005,18-20,Laramie County,3388,207,50,64,3709
2005,18-20,Lincoln County,555,1,5,2,563
2005,18-20,Natrona County,2939,54,45,27,3065
2005,18-20,Niobrara County,58,0,0,0,58
2005,18-20,Park County,1269,11,17,19,1316
2005,18-20,Platte County,262,2,3,3,270
2005,18-20,Sheridan County,1052,13,25,10,1100
2005,18-20,Sublette County,220,3,3,3,229
2005,18-20,Sweetwater County,1792,29,24,22,1867
2005,18-20,Teton County,518,5,6,6,535
2005,18-20,Uinta County,770,6,19,3,798
2005,18-20,Washakie County,269,1,5,1,276
2005,18-20,Weston County,248,1,11,1,261
2000,18-20,Albany County,4024,67,46,54,4191
2000,18-20,Big Horn County,427,1,5,1,434
2000,18-20,Campbell County,1466,3,20,2,1491
2000,18-20,Carbon County,562,8,10,4,584
2000,18-20,Converse County,403,1,7,3,414
2000,18-20,Crook County,205,1,3,0,209
2000,18-20,Fremont County,1145,6,445,4,1600
2000,18-20,Goshen County,659,5,7,5,676
2000,18-20,Hot Springs County,155,0,5,1,161
2000,18-20,Johnson County,193,0,3,3,199
2000,18-20,Laramie County,3103,193,52,51,3399
2000,18-20,Lincoln County,561,2,5,3,571
2000,18-20,Natrona County,3226,48,46,20,3340
2000,18-20,Niobrara County,76,1,0,0,77
2000,18-20,Park County,1339,0,13,9,1361
2000,18-20,Platte County,289,3,4,2,298
2000,18-20,Sheridan County,1063,10,26,3,1102
2000,18-20,Sublette County,155,1,0,0,156
2000,18-20,Sweetwater County,1901,18,24,27,1970
2000,18-20,Teton County,539,1,3,4,547
2000,18-20,Uinta County,872,2,20,2,896
2000,18-20,Washakie County,280,2,3,1,286
2000,18-20,Weston County,248,0,14,0,262
2002,18-20,Albany County,4346,60,40,76,4522
2002,18-20,Big Horn County,458,2,5,1,466
2002,18-20,Campbell County,1574,10,26,8,1618
2002,18-20,Carbon County,598,7,8,5,618
2002,18-20,Converse County,468,1,6,3,478
2002,18-20,Crook County,249,1,2,0,252
2002,18-20,Fremont County,1146,6,400,8,1560
2002,18-20,Goshen County,616,5,7,5,633
2002,18-20,Hot Springs County,171,0,4,1,176
2002,18-20,Johnson County,260,0,2,3,265
2002,18-20,Laramie County,3226,213,46,70,3555
2002,18-20,Lincoln County,619,2,4,3,628
2002,18-20,Natrona County,2868,57,46,26,2997
2002,18-20,Niobrara County,73,1,0,0,74
2002,18-20,Park County,1251,2,13,14,1280
2002,18-20,Platte County,304,2,4,2,312
2002,18-20,Sheridan County,1087,10,24,5,1126
2002,18-20,Sublette County,209,1,1,1,212
2002,18-20,Sweetwater County,1890,19,22,26,1957
2002,18-20,Teton County,532,2,3,5,542
2002,18-20,Uinta County,945,2,18,2,967
2002,18-20,Washakie County,299,2,4,1,306
2002,18-20,Weston County,287,0,12,0,299
1992,18-20,Albany County,3877,59,24,50,4010
1992,18-20,Big Horn County,335,0,5,0,340
1992,18-20,Campbell County,1074,1,13,0,1088
1992,18-20,Carbon County,532,5,9,4,550
1992,18-20,Converse County,362,0,6,0,368
1992,18-20,Crook County,166,0,2,0,168
1992,18-20,Fremont County,893,3,334,2,1232
1992,18-20,Goshen County,540,5,2,4,551
1992,18-20,Hot Springs County,129,2,4,0,135
1992,18-20,Johnson County,202,0,0,0,202
1992,18-20,Laramie County,2974,153,40,48,3215
1992,18-20,Lincoln County,433,1,5,0,439
1992,18-20,Natrona County,2697,62,25,15,2799
1992,18-20,Niobrara County,67,2,0,0,69
1992,18-20,Park County,1212,0,13,14,1239
1992,18-20,Platte County,241,0,0,2,243
1992,18-20,Sheridan County,930,11,12,0,953
1992,18-20,Sublette County,143,0,0,0,143
1992,18-20,Sweetwater County,1659,17,10,17,1703
1992,18-20,Teton County,349,2,6,0,357
1992,18-20,Uinta County,696,0,3,6,705
1992,18-20,Washakie County,264,1,1,0,266
1992,18-20,Weston County,205,0,13,0,218
2007,18-20,Albany County,4293,75,39,83,4490
2007,18-20,Big Horn County,341,8,5,1,355
2007,18-20,Campbell County,1644,21,39,16,1720
2007,18-20,Carbon County,487,5,6,4,502
2007,18-20,Converse County,460,1,3,1,465
2007,18-20,Crook County,218,1,1,0,220
2007,18-20,Fremont County,1059,4,475,7,1545
2007,18-20,Goshen County,606,12,9,5,632
2007,18-20,Hot Springs County,145,0,4,1,150
2007,18-20,Johnson County,208,0,5,2,215
2007,18-20,Laramie County,3163,184,48,59,3454
2007,18-20,Lincoln County,511,2,3,1,517
2007,18-20,Natrona County,2777,55,45,31,2908
2007,18-20,Niobrara County,52,0,0,0,52
2007,18-20,Park County,1235,15,17,23,1290
2007,18-20,Platte County,229,1,2,3,235
2007,18-20,Sheridan County,1017,13,26,13,1069
2007,18-20,Sublette County,256,3,7,3,269
2007,18-20,Sweetwater County,1754,29,29,22,1834
2007,18-20,Teton County,473,5,6,8,492
2007,18-20,Uinta County,750,7,21,3,781
2007,18-20,Washakie County,244,1,5,3,253
2007,18-20,Weston County,241,1,8,1,251
1991,18-20,Albany County,4014,60,19,60,4153
1991,18-20,Big Horn County,326,0,5,0,331
1991,18-20,Campbell County,1024,1,14,0,1039
1991,18-20,Carbon County,538,5,8,3,554
1991,18-20,Converse County,350,0,5,0,355
1991,18-20,Crook County,155,0,2,0,157
1991,18-20,Fremont County,887,3,340,3,1233
1991,18-20,Goshen County,524,6,2,4,536
1991,18-20,Hot Springs County,123,1,4,0,128
1991,18-20,Johnson County,203,0,0,0,203
1991,18-20,Laramie County,2934,131,43,51,3159
1991,18-20,Lincoln County,416,1,7,0,424
1991,18-20,Natrona County,2610,61,23,14,2708
1991,18-20,Niobrara County,63,2,0,0,65
1991,18-20,Park County,1181,0,13,11,1205
1991,18-20,Platte County,240,0,0,2,242
1991,18-20,Sheridan County,904,8,10,0,922
1991,18-20,Sublette County,142,0,0,0,142
1991,18-20,Sweetwater County,1590,19,10,12,1631
1991,18-20,Teton County,326,2,6,0,334
1991,18-20,Uinta County,665,0,3,6,674
1991,18-20,Washakie County,251,1,1,0,253
1991,18-20,Weston County,193,0,13,0,206
1993,11-17,Albany County,2480,30,42,36,2588
1993,11-17,Big Horn County,1395,0,9,3,1407
1993,11-17,Campbell County,4323,6,68,13,4410
1993,11-17,Carbon County,1991,6,7,10,2014
1993,11-17,Converse County,1575,3,19,3,1600
1993,11-17,Crook County,718,0,2,0,720
1993,11-17,Fremont County,3287,7,1109,6,4409
1993,11-17,Goshen County,1448,0,15,0,1463
1993,11-17,Hot Springs County,555,0,19,0,574
1993,11-17,Johnson County,727,0,10,1,738
1993,11-17,Laramie County,7976,277,90,107,8450
1993,11-17,Lincoln County,2109,1,13,0,2123
1993,11-17,Natrona County,7199,66,65,41,7371
1993,11-17,Niobrara County,266,0,0,0,266
1993,11-17,Park County,2791,3,14,11,2819
1993,11-17,Platte County,1019,0,1,0,1020
1993,11-17,Sheridan County,2870,4,34,16,2924
1993,11-17,Sublette County,614,0,0,0,614
1993,11-17,Sweetwater County,5549,46,58,26,5679
1993,11-17,Teton County,1173,1,8,4,1186
1993,11-17,Uinta County,3145,1,29,5,3180
1993,11-17,Washakie County,1100,0,14,2,1116
1993,11-17,Weston County,829,0,3,0,832
1990,11-17,Albany County,2228,18,31,39,2316
1990,11-17,Big Horn County,1287,0,6,4,1297
1990,11-17,Campbell County,3838,7,49,13,3907
1990,11-17,Carbon County,1995,6,6,10,2017
1990,11-17,Converse County,1443,2,18,4,1467
1990,11-17,Crook County,656,0,1,0,657
1990,11-17,Fremont County,3061,6,893,7,3967
1990,11-17,Goshen County,1380,0,15,0,1395
1990,11-17,Hot Springs County,545,0,18,0,563
1990,11-17,Johnson County,669,0,8,1,678
1990,11-17,Laramie County,6965,256,69,114,7404
1990,11-17,Lincoln County,1914,1,12,0,1927
1990,11-17,Natrona County,6472,55,46,41,6614
1990,11-17,Niobrara County,253,0,0,0,253
1990,11-17,Park County,2454,3,17,11,2485
1990,11-17,Platte County,938,0,1,0,939
1990,11-17,Sheridan County,2571,4,29,21,2625
1990,11-17,Sublette County,536,0,0,0,536
1990,11-17,Sweetwater County,5082,39,41,29,5191
1990,11-17,Teton County,890,1,11,4,906
1990,11-17,Uinta County,2833,1,23,5,2862
1990,11-17,Washakie County,1039,0,10,3,1052
1990,11-17,Weston County,764,0,3,0,767
2009,11-17,Albany County,2026,52,23,67,2168
2009,11-17,Big Horn County,1214,11,9,3,1237
2009,11-17,Campbell County,4498,44,94,23,4659
2009,11-17,Carbon County,1346,8,30,8,1392
2009,11-17,Converse County,1358,29,16,3,1406
2009,11-17,Crook County,640,2,8,0,650
2009,11-17,Fremont County,2461,20,1202,21,3704
2009,11-17,Goshen County,1087,16,18,5,1126
2009,11-17,Hot Springs County,377,6,10,4,397
2009,11-17,Johnson County,734,6,7,3,750
2009,11-17,Laramie County,7568,394,160,130,8252
2009,11-17,Lincoln County,1913,15,31,7,1966
2009,11-17,Natrona County,6510,158,125,62,6855
2009,11-17,Niobrara County,214,2,0,2,218
2009,11-17,Park County,2345,22,33,19,2419
2009,11-17,Platte County,776,4,7,8,795
2009,11-17,Sheridan County,2406,25,86,16,2533
2009,11-17,Sublette County,855,6,18,4,883
2009,11-17,Sweetwater County,4029,83,67,43,4222
2009,11-17,Teton County,1411,10,15,30,1466
2009,11-17,Uinta County,2318,20,37,14,2389
2009,11-17,Washakie County,780,8,26,10,824
2009,11-17,Weston County,601,3,15,0,619
2015,11-17,Albany County,1938,68,40,63,2109
2015,11-17,Big Horn County,1211,14,11,11,1247
2015,11-17,Campbell County,4794,63,104,44,5005
2015,11-17,Carbon County,1318,25,26,10,1379
2015,11-17,Converse County,1337,23,20,9,1389
2015,11-17,Crook County,635,8,13,1,657
2015,11-17,Fremont County,2398,38,1303,22,3761
2015,11-17,Goshen County,1084,14,13,9,1120
2015,11-17,Hot Springs County,388,2,5,3,398
2015,11-17,Johnson County,674,10,11,0,695
2015,11-17,Laramie County,7894,360,189,155,8598
2015,11-17,Lincoln County,1922,20,21,7,1970
2015,11-17,Natrona County,6791,170,143,81,7185
2015,11-17,Niobrara County,200,4,0,4,208
2015,11-17,Park County,2209,23,32,14,2278
2015,11-17,Platte County,682,7,7,5,701
2015,11-17,Sheridan County,2428,69,57,13,2567
2015,11-17,Sublette County,833,11,13,28,885
2015,11-17,Sweetwater County,4303,83,75,53,4514
2015,11-17,Teton County,1440,12,21,32,1505
2015,11-17,Uinta County,2334,26,31,14,2405
2015,11-17,Washakie County,822,7,22,9,860
2015,11-17,Weston County,581,12,9,4,606
2008,11-17,Albany County,1971,46,27,51,2095
2008,11-17,Big Horn County,1217,11,9,4,1241
2008,11-17,Campbell County,4348,40,84,28,4500
2008,11-17,Carbon County,1324,7,26,11,1368
2008,11-17,Converse County,1337,22,12,2,1373
2008,11-17,Crook County,665,2,7,0,674
2008,11-17,Fremont County,2497,17,1188,23,3725
2008,11-17,Goshen County,1062,11,18,5,1096
2008,11-17,Hot Springs County,371,6,10,5,392
2008,11-17,Johnson County,762,6,7,3,778
2008,11-17,Laramie County,7648,362,153,120,8283
2008,11-17,Lincoln County,1928,14,27,5,1974
2008,11-17,Natrona County,6552,133,131,64,6880
2008,11-17,Niobrara County,229,2,0,2,233
2008,11-17,Park County,2379,23,31,16,2449
2008,11-17,Platte County,826,4,7,6,843
2008,11-17,Sheridan County,2452,26,85,18,2581
2008,11-17,Sublette County,818,6,19,5,848
2008,11-17,Sweetwater County,3969,76,76,45,4166
2008,11-17,Teton County,1451,8,14,23,1496
2008,11-17,Uinta County,2298,20,33,16,2367
2008,11-17,Washakie County,767,8,24,9,808
2008,11-17,Weston County,574,3,13,0,590
2001,11-17,Albany County,2179,43,44,35,2301
2001,11-17,Big Horn County,1347,6,19,7,1379
2001,11-17,Campbell County,4518,10,66,24,4618
2001,11-17,Carbon County,1548,14,20,16,1598
2001,11-17,Converse County,1463,9,16,5,1493
2001,11-17,Crook County,733,0,12,0,745
2001,11-17,Fremont County,2994,11,1179,14,4198
2001,11-17,Goshen County,1266,5,20,10,1301
2001,11-17,Hot Springs County,482,1,16,1,500
2001,11-17,Johnson County,749,0,5,1,755
2001,11-17,Laramie County,8097,291,112,109,8609
2001,11-17,Lincoln County,1981,10,14,5,2010
2001,11-17,Natrona County,7012,100,134,47,7293
2001,11-17,Niobrara County,247,0,0,1,248
2001,11-17,Park County,2754,7,17,20,2798
2001,11-17,Platte County,1021,5,9,3,1038
2001,11-17,Sheridan County,2844,13,74,26,2957
2001,11-17,Sublette County,662,2,4,3,671
2001,11-17,Sweetwater County,4454,58,56,20,4588
2001,11-17,Teton County,1556,3,5,11,1575
2001,11-17,Uinta County,2796,3,40,11,2850
2001,11-17,Washakie County,995,5,11,8,1019
2001,11-17,Weston County,745,3,10,1,759
1996,11-17,Albany County,2565,29,38,40,2672
1996,11-17,Big Horn County,1507,0,9,3,1519
1996,11-17,Campbell County,4626,5,76,18,4725
1996,11-17,Carbon County,1928,9,5,16,1958
1996,11-17,Converse County,1653,5,19,2,1679
1996,11-17,Crook County,796,0,5,0,801
1996,11-17,Fremont County,3436,8,1215,5,4664
1996,11-17,Goshen County,1433,0,20,0,1453
1996,11-17,Hot Springs County,571,0,19,0,590
1996,11-17,Johnson County,789,0,7,1,797
1996,11-17,Laramie County,8390,297,99,110,8896
1996,11-17,Lincoln County,2245,3,7,0,2255
1996,11-17,Natrona County,7515,90,91,43,7739
1996,11-17,Niobrara County,272,0,0,0,272
1996,11-17,Park County,3020,6,17,14,3057
1996,11-17,Platte County,1079,0,1,0,1080
1996,11-17,Sheridan County,3057,8,50,20,3135
1996,11-17,Sublette County,686,0,0,0,686
1996,11-17,Sweetwater County,5442,46,62,23,5573
1996,11-17,Teton County,1358,1,8,4,1371
1996,11-17,Uinta County,3197,2,30,6,3235
1996,11-17,Washakie County,1127,0,10,3,1140
1996,11-17,Weston County,864,0,5,0,869
2010,11-17,Albany County,1980,49,26,57,2112
2010,11-17,Big Horn County,1217,10,10,5,1242
2010,11-17,Campbell County,4525,48,92,31,4696
2010,11-17,Carbon County,1309,7,27,10,1353
2010,11-17,Converse County,1338,25,10,1,1374
2010,11-17,Crook County,634,6,8,0,648
2010,11-17,Fremont County,2459,30,1204,19,3712
2010,11-17,Goshen County,1114,15,20,5,1154
2010,11-17,Hot Springs County,375,8,10,5,398
2010,11-17,Johnson County,713,7,7,3,730
2010,11-17,Laramie County,7596,348,151,132,8227
2010,11-17,Lincoln County,1912,18,29,9,1968
2010,11-17,Natrona County,6355,140,116,64,6675
2010,11-17,Niobrara County,207,2,0,2,211
2010,11-17,Park County,2299,24,34,18,2375
2010,11-17,Platte County,741,8,6,8,763
2010,11-17,Sheridan County,2378,26,68,14,2486
2010,11-17,Sublette County,882,9,21,5,917
2010,11-17,Sweetwater County,3959,73,78,44,4154
2010,11-17,Teton County,1421,10,18,26,1475
2010,11-17,Uinta County,2364,24,34,16,2438
2010,11-17,Washakie County,799,6,29,9,843
2010,11-17,Weston County,594,5,13,0,612
2014,11-17,Albany County,1927,59,32,81,2099
2014,11-17,Big Horn County,1195,12,12,11,1230
2014,11-17,Campbell County,4638,57,113,43,4851
2014,11-17,Carbon County,1344,17,27,14,1402
2014,11-17,Converse County,1294,17,18,8,1337
2014,11-17,Crook County,603,7,13,1,624
2014,11-17,Fremont County,2406,37,1275,23,3741
2014,11-17,Goshen County,1094,20,16,8,1138
2014,11-17,Hot Springs County,395,5,5,4,409
2014,11-17,Johnson County,653,7,12,1,673
2014,11-17,Laramie County,7696,369,176,133,8374
2014,11-17,Lincoln County,1920,19,23,11,1973
2014,11-17,Natrona County,6608,181,140,76,7005
2014,11-17,Niobrara County,200,4,0,0,204
2014,11-17,Park County,2247,25,37,20,2329
2014,11-17,Platte County,741,8,5,3,757
2014,11-17,Sheridan County,2458,63,51,13,2585
2014,11-17,Sublette County,871,12,13,20,916
2014,11-17,Sweetwater County,4304,85,75,40,4504
2014,11-17,Teton County,1435,14,20,29,1498
2014,11-17,Uinta County,2334,25,27,14,2400
2014,11-17,Washakie County,828,8,24,6,866
2014,11-17,Weston County,571,16,15,3,605
2017,11-17,Albany County,2066,96,39,56,2257
2017,11-17,Big Horn County,1242,11,9,11,1273
2017,11-17,Campbell County,4615,60,100,38,4813
2017,11-17,Carbon County,1293,25,22,11,1351
2017,11-17,Converse County,1318,12,19,9,1358
2017,11-17,Crook County,640,8,16,2,666
2017,11-17,Fremont County,2379,35,1348,23,3785
2017,11-17,Goshen County,1030,11,18,8,1067
2017,11-17,Hot Springs County,389,2,3,3,397
2017,11-17,Johnson County,726,12,19,1,758
2017,11-17,Laramie County,8103,377,167,167,8814
2017,11-17,Lincoln County,2029,16,29,10,2084
2017,11-17,Natrona County,6840,163,144,71,7218
2017,11-17,Niobrara County,148,3,3,0,154
2017,11-17,Park County,2322,21,35,13,2391
2017,11-17,Platte County,648,10,5,4,667
2017,11-17,Sheridan County,2475,89,52,14,2630
2017,11-17,Sublette County,803,15,11,39,868
2017,11-17,Sweetwater County,4323,93,82,43,4541
2017,11-17,Teton County,1532,20,22,32,1606
2017,11-17,Uinta County,2278,26,30,18,2352
2017,11-17,Washakie County,843,10,14,8,875
2017,11-17,Weston County,560,13,11,4,588
1999,11-17,Albany County,2329,43,44,38,2454
1999,11-17,Big Horn County,1436,0,13,4,1453
1999,11-17,Campbell County,4543,5,77,25,4650
1999,11-17,Carbon County,1736,10,5,28,1779
1999,11-17,Converse County,1568,10,19,4,1601
1999,11-17,Crook County,775,0,7,0,782
1999,11-17,Fremont County,3228,7,1227,10,4472
1999,11-17,Goshen County,1323,0,25,0,1348
1999,11-17,Hot Springs County,524,0,22,0,546
1999,11-17,Johnson County,768,0,6,1,775
1999,11-17,Laramie County,8113,298,104,107,8622
1999,11-17,Lincoln County,2113,4,5,0,2122
1999,11-17,Natrona County,7200,98,111,42,7451
1999,11-17,Niobrara County,255,0,0,0,255
1999,11-17,Park County,2934,5,18,14,2971
1999,11-17,Platte County,1064,0,1,0,1065
1999,11-17,Sheridan County,2956,10,70,26,3062
1999,11-17,Sublette County,687,0,0,0,687
1999,11-17,Sweetwater County,4958,49,69,24,5100
1999,11-17,Teton County,1481,2,5,3,1491
1999,11-17,Uinta County,2993,2,33,6,3034
1999,11-17,Washakie County,1075,0,9,4,1088
1999,11-17,Weston County,802,0,3,0,805
2012,11-17,Albany County,1969,54,27,63,2113
2012,11-17,Big Horn County,1216,16,14,12,1258
2012,11-17,Campbell County,4635,46,90,33,4804
2012,11-17,Carbon County,1301,15,32,12,1360
2012,11-17,Converse County,1321,29,9,6,1365
2012,11-17,Crook County,604,8,10,0,622
2012,11-17,Fremont County,2463,30,1201,17,3711
2012,11-17,Goshen County,1106,14,21,7,1148
2012,11-17,Hot Springs County,380,5,8,5,398
2012,11-17,Johnson County,680,6,6,1,693
2012,11-17,Laramie County,7609,312,150,122,8193
2012,11-17,Lincoln County,1863,20,22,6,1911
2012,11-17,Natrona County,6421,160,136,77,6794
2012,11-17,Niobrara County,203,1,0,1,205
2012,11-17,Park County,2270,21,37,25,2353
2012,11-17,Platte County,692,5,10,9,716
2012,11-17,Sheridan County,2400,31,63,16,2510
2012,11-17,Sublette County,895,11,17,12,935
2012,11-17,Sweetwater County,4184,84,79,39,4386
2012,11-17,Teton County,1395,11,18,32,1456
2012,11-17,Uinta County,2306,22,28,18,2374
2012,11-17,Washakie County,810,8,26,9,853
2012,11-17,Weston County,565,11,14,1,591
1998,11-17,Albany County,2387,36,37,36,2496
1998,11-17,Big Horn County,1492,0,12,3,1507
1998,11-17,Campbell County,4578,6,75,25,4684
1998,11-17,Carbon County,1803,13,5,22,1843
1998,11-17,Converse County,1601,7,19,4,1631
1998,11-17,Crook County,793,0,6,0,799
1998,11-17,Fremont County,3353,6,1183,10,4552
1998,11-17,Goshen County,1390,0,22,0,1412
1998,11-17,Hot Springs County,559,0,18,0,577
1998,11-17,Johnson County,777,0,6,1,784
1998,11-17,Laramie County,8260,293,101,110,8764
1998,11-17,Lincoln County,2130,3,6,0,2139
1998,11-17,Natrona County,7350,85,100,42,7577
1998,11-17,Niobrara County,270,0,0,0,270
1998,11-17,Park County,3032,3,15,16,3066
1998,11-17,Platte County,1088,0,1,0,1089
1998,11-17,Sheridan County,3014,8,56,23,3101
1998,11-17,Sublette County,684,0,0,0,684
1998,11-17,Sweetwater County,5174,50,62,20,5306
1998,11-17,Teton County,1443,1,5,4,1453
1998,11-17,Uinta County,3104,6,41,7,3158
1998,11-17,Washakie County,1118,0,9,4,1131
1998,11-17,Weston County,832,0,3,0,835
2006,11-17,Albany County,1946,46,30,34,2056
2006,11-17,Big Horn County,1240,11,11,3,1265
2006,11-17,Campbell County,4269,35,84,24,4412
2006,11-17,Carbon County,1310,9,28,12,1359
2006,11-17,Converse County,1382,23,13,4,1422
2006,11-17,Crook County,648,2,7,0,657
2006,11-17,Fremont County,2580,15,1251,20,3866
2006,11-17,Goshen County,1165,11,19,5,1200
2006,11-17,Hot Springs County,351,5,8,2,366
2006,11-17,Johnson County,762,6,6,2,776
2006,11-17,Laramie County,7846,328,128,128,8430
2006,11-17,Lincoln County,1864,13,22,5,1904
2006,11-17,Natrona County,6750,107,123,50,7030
2006,11-17,Niobrara County,207,1,0,2,210
2006,11-17,Park County,2439,19,24,17,2499
2006,11-17,Platte County,900,6,4,4,914
2006,11-17,Sheridan County,2441,20,69,17,2547
2006,11-17,Sublette County,740,4,14,3,761
2006,11-17,Sweetwater County,3884,59,68,32,4043
2006,11-17,Teton County,1555,6,11,22,1594
2006,11-17,Uinta County,2335,17,37,12,2401
2006,11-17,Washakie County,810,9,21,8,848
2006,11-17,Weston County,598,2,9,0,609
1995,11-17,Albany County,2550,27,44,37,2658
1995,11-17,Big Horn County,1488,0,8,4,1500
1995,11-17,Campbell County,4552,5,67,17,4641
1995,11-17,Carbon County,1985,8,6,15,2014
1995,11-17,Converse County,1630,4,19,3,1656
1995,11-17,Crook County,776,0,4,0,780
1995,11-17,Fremont County,3431,7,1173,6,4617
1995,11-17,Goshen County,1435,0,16,0,1451
1995,11-17,Hot Springs County,564,0,19,0,583
1995,11-17,Johnson County,772,0,8,1,781
1995,11-17,Laramie County,8302,296,93,102,8793
1995,11-17,Lincoln County,2228,2,8,0,2238
1995,11-17,Natrona County,7510,79,88,41,7718
1995,11-17,Niobrara County,275,0,0,0,275
1995,11-17,Park County,3001,3,20,11,3035
1995,11-17,Platte County,1059,0,1,0,1060
1995,11-17,Sheridan County,3022,7,44,21,3094
1995,11-17,Sublette County,671,0,0,0,671
1995,11-17,Sweetwater County,5549,48,61,22,5680
1995,11-17,Teton County,1303,2,6,3,1314
1995,11-17,Uinta County,3202,1,28,6,3237
1995,11-17,Washakie County,1137,0,10,3,1150
1995,11-17,Weston County,857,0,4,0,861
2011,11-17,Albany County,1949,52,26,59,2086
2011,11-17,Big Horn County,1220,12,10,8,1250
2011,11-17,Campbell County,4541,50,87,34,4712
2011,11-17,Carbon County,1314,13,28,11,1366
2011,11-17,Converse County,1291,27,10,4,1332
2011,11-17,Crook County,625,8,9,1,643
2011,11-17,Fremont County,2451,27,1189,16,3683
2011,11-17,Goshen County,1111,16,20,6,1153
2011,11-17,Hot Springs County,364,8,7,5,384
2011,11-17,Johnson County,707,9,7,3,726
2011,11-17,Laramie County,7564,330,142,128,8164
2011,11-17,Lincoln County,1873,18,24,9,1924
2011,11-17,Natrona County,6356,146,130,70,6702
2011,11-17,Niobrara County,199,6,0,1,206
2011,11-17,Park County,2281,20,38,20,2359
2011,11-17,Platte County,728,4,6,9,747
2011,11-17,Sheridan County,2400,30,62,18,2510
2011,11-17,Sublette County,895,10,19,6,930
2011,11-17,Sweetwater County,4077,78,79,39,4273
2011,11-17,Teton County,1423,6,20,32,1481
2011,11-17,Uinta County,2339,21,33,16,2409
2011,11-17,Washakie County,815,8,25,8,856
2011,11-17,Weston County,577,7,14,1,599
2004,11-17,Albany County,2063,48,34,39,2184
2004,11-17,Big Horn County,1325,6,17,6,1354
2004,11-17,Campbell County,4283,22,80,19,4404
2004,11-17,Carbon County,1343,12,20,13,1388
2004,11-17,Converse County,1406,12,13,3,1434
2004,11-17,Crook County,682,0,10,0,692
2004,11-17,Fremont County,2706,17,1243,17,3983
2004,11-17,Goshen County,1178,8,21,5,1212
2004,11-17,Hot Springs County,389,0,16,3,408
2004,11-17,Johnson County,746,1,5,2,754
2004,11-17,Laramie County,8017,300,129,115,8561
2004,11-17,Lincoln County,1919,13,15,7,1954
2004,11-17,Natrona County,6755,97,120,46,7018
2004,11-17,Niobrara County,225,1,0,1,227
2004,11-17,Park County,2578,15,19,17,2629
2004,11-17,Platte County,954,3,8,3,968
2004,11-17,Sheridan County,2572,19,74,19,2684
2004,11-17,Sublette County,683,3,11,3,700
2004,11-17,Sweetwater County,4027,65,60,29,4181
2004,11-17,Teton County,1576,6,10,13,1605
2004,11-17,Uinta County,2404,11,40,13,2468
2004,11-17,Washakie County,868,5,17,8,898
2004,11-17,Weston County,660,4,10,1,675
2003,11-17,Albany County,2026,45,36,36,2143
2003,11-17,Big Horn County,1327,7,16,9,1359
2003,11-17,Campbell County,4395,24,73,19,4511
2003,11-17,Carbon County,1421,15,17,14,1467
2003,11-17,Converse County,1473,14,14,7,1508
2003,11-17,Crook County,691,0,11,0,702
2003,11-17,Fremont County,2804,13,1237,15,4069
2003,11-17,Goshen County,1226,9,22,10,1267
2003,11-17,Hot Springs County,441,1,17,1,460
2003,11-17,Johnson County,744,1,5,1,751
2003,11-17,Laramie County,7968,278,126,103,8475
2003,11-17,Lincoln County,1901,15,13,6,1935
2003,11-17,Natrona County,6814,85,128,46,7073
2003,11-17,Niobrara County,219,1,0,0,220
2003,11-17,Park County,2628,12,20,21,2681
2003,11-17,Platte County,961,4,8,4,977
2003,11-17,Sheridan County,2608,18,78,16,2720
2003,11-17,Sublette County,678,3,6,3,690
2003,11-17,Sweetwater County,4124,55,52,24,4255
2003,11-17,Teton County,1545,4,6,10,1565
2003,11-17,Uinta County,2548,12,35,13,2608
2003,11-17,Washakie County,900,5,16,6,927
2003,11-17,Weston County,675,4,10,1,690
1997,11-17,Albany County,2483,33,41,42,2599
1997,11-17,Big Horn County,1489,0,11,3,1503
1997,11-17,Campbell County,4609,5,74,21,4709
1997,11-17,Carbon County,1888,7,5,22,1922
1997,11-17,Converse County,1653,6,20,4,1683
1997,11-17,Crook County,797,0,5,0,802
1997,11-17,Fremont County,3432,6,1205,5,4648
1997,11-17,Goshen County,1452,0,19,0,1471
1997,11-17,Hot Springs County,571,0,19,0,590
1997,11-17,Johnson County,791,0,5,1,797
1997,11-17,Laramie County,8374,274,108,115,8871
1997,11-17,Lincoln County,2185,3,5,0,2193
1997,11-17,Natrona County,7515,78,97,42,7732
1997,11-17,Niobrara County,270,0,0,0,270
1997,11-17,Park County,3073,5,19,14,3111
1997,11-17,Platte County,1095,0,1,0,1096
1997,11-17,Sheridan County,3055,6,54,23,3138
1997,11-17,Sublette County,687,0,0,0,687
1997,11-17,Sweetwater County,5316,45,58,24,5443
1997,11-17,Teton County,1418,1,6,4,1429
1997,11-17,Uinta County,3158,6,31,8,3203
1997,11-17,Washakie County,1141,0,10,3,1154
1997,11-17,Weston County,853,0,3,0,856
1994,11-17,Albany County,2537,26,37,37,2637
1994,11-17,Big Horn County,1447,0,9,4,1460
1994,11-17,Campbell County,4434,4,72,15,4525
1994,11-17,Carbon County,2001,8,8,12,2029
1994,11-17,Converse County,1602,4,20,3,1629
1994,11-17,Crook County,761,0,4,0,765
1994,11-17,Fremont County,3376,7,1161,5,4549
1994,11-17,Goshen County,1458,0,17,0,1475
1994,11-17,Hot Springs County,580,0,22,0,602
1994,11-17,Johnson County,762,0,9,1,772
1994,11-17,Laramie County,8232,282,96,104,8714
1994,11-17,Lincoln County,2197,3,10,0,2210
1994,11-17,Natrona County,7443,81,77,38,7639
1994,11-17,Niobrara County,268,0,0,0,268
1994,11-17,Park County,2924,3,20,13,2960
1994,11-17,Platte County,1049,0,1,0,1050
1994,11-17,Sheridan County,2958,6,44,19,3027
1994,11-17,Sublette County,663,0,0,0,663
1994,11-17,Sweetwater County,5585,48,60,22,5715
1994,11-17,Teton County,1243,1,7,4,1255
1994,11-17,Uinta County,3216,1,31,5,3253
1994,11-17,Washakie County,1139,0,11,2,1152
1994,11-17,Weston County,848,0,4,0,852
2013,11-17,Albany County,1903,52,36,79,2070
2013,11-17,Big Horn County,1193,17,11,10,1231
2013,11-17,Campbell County,4646,55,95,34,4830
2013,11-17,Carbon County,1322,15,32,13,1382
2013,11-17,Converse County,1342,23,21,7,1393
2013,11-17,Crook County,610,10,8,1,629
2013,11-17,Fremont County,2435,40,1235,20,3730
2013,11-17,Goshen County,1092,12,19,10,1133
2013,11-17,Hot Springs County,378,4,3,5,390
2013,11-17,Johnson County,663,6,8,1,678
2013,11-17,Laramie County,7698,344,158,123,8323
2013,11-17,Lincoln County,1863,20,24,7,1914
2013,11-17,Natrona County,6610,177,145,70,7002
2013,11-17,Niobrara County,201,2,0,1,204
2013,11-17,Park County,2239,27,36,21,2323
2013,11-17,Platte County,703,7,4,5,719
2013,11-17,Sheridan County,2362,48,59,15,2484
2013,11-17,Sublette County,866,7,15,16,904
2013,11-17,Sweetwater County,4273,93,68,40,4474
2013,11-17,Teton County,1388,14,15,30,1447
2013,11-17,Uinta County,2303,24,25,17,2369
2013,11-17,Washakie County,823,3,25,7,858
2013,11-17,Weston County,542,9,14,3,568
2016,11-17,Albany County,2018,68,44,62,2192
2016,11-17,Big Horn County,1242,14,11,9,1276
2016,11-17,Campbell County,4809,67,102,43,5021
2016,11-17,Carbon County,1326,19,24,13,1382
2016,11-17,Converse County,1321,15,19,10,1365
2016,11-17,Crook County,662,8,14,1,685
2016,11-17,Fremont County,2389,36,1326,25,3776
2016,11-17,Goshen County,1046,13,13,8,1080
2016,11-17,Hot Springs County,395,3,4,2,404
2016,11-17,Johnson County,694,11,14,2,721
2016,11-17,Laramie County,7972,367,171,163,8673
2016,11-17,Lincoln County,1975,23,26,6,2030
2016,11-17,Natrona County,6851,167,141,78,7237
2016,11-17,Niobrara County,179,2,3,4,188
2016,11-17,Park County,2288,21,30,16,2355
2016,11-17,Platte County,688,9,5,2,704
2016,11-17,Sheridan County,2407,74,52,15,2548
2016,11-17,Sublette County,827,13,12,33,885
2016,11-17,Sweetwater County,4298,94,83,52,4527
2016,11-17,Teton County,1459,20,22,25,1526
2016,11-17,Uinta County,2300,22,31,19,2372
2016,11-17,Washakie County,830,7,15,9,861
2016,11-17,Weston County,591,8,11,4,614
2005,11-17,Albany County,1987,48,31,37,2103
2005,11-17,Big Horn County,1274,8,12,3,1297
2005,11-17,Campbell County,4227,33,78,23,4361
2005,11-17,Carbon County,1324,10,23,13,1370
2005,11-17,Converse County,1359,18,14,5,1396
2005,11-17,Crook County,670,0,9,0,679
2005,11-17,Fremont County,2636,18,1265,25,3944
2005,11-17,Goshen County,1196,9,23,5,1233
2005,11-17,Hot Springs County,378,3,11,3,395
2005,11-17,Johnson County,733,5,6,1,745
2005,11-17,Laramie County,7904,316,130,116,8466
2005,11-17,Lincoln County,1893,12,18,3,1926
2005,11-17,Natrona County,6697,104,127,52,6980
2005,11-17,Niobrara County,216,1,0,2,219
2005,11-17,Park County,2490,16,21,18,2545
2005,11-17,Platte County,928,6,8,4,946
2005,11-17,Sheridan County,2532,20,70,18,2640
2005,11-17,Sublette County,733,2,11,3,749
2005,11-17,Sweetwater County,3947,59,68,38,4112
2005,11-17,Teton County,1544,4,11,18,1577
2005,11-17,Uinta County,2368,14,40,14,2436
2005,11-17,Washakie County,816,8,22,6,852
2005,11-17,Weston County,621,2,13,0,636
2000,11-17,Albany County,2230,42,41,34,2347
2000,11-17,Big Horn County,1392,7,19,8,1426
2000,11-17,Campbell County,4577,11,65,23,4676
2000,11-17,Carbon County,1649,15,18,20,1702
2000,11-17,Converse County,1536,8,15,6,1565
2000,11-17,Crook County,794,0,12,0,806
2000,11-17,Fremont County,3157,11,1197,12,4377
2000,11-17,Goshen County,1286,5,19,9,1319
2000,11-17,Hot Springs County,500,1,17,1,519
2000,11-17,Johnson County,772,0,6,1,779
2000,11-17,Laramie County,8033,302,103,108,8546
2000,11-17,Lincoln County,2081,10,8,5,2104
2000,11-17,Natrona County,7050,87,108,41,7286
2000,11-17,Niobrara County,250,0,0,1,251
2000,11-17,Park County,2894,7,15,23,2939
2000,11-17,Platte County,1005,7,9,3,1024
2000,11-17,Sheridan County,2906,11,67,23,3007
2000,11-17,Sublette County,690,2,2,3,697
2000,11-17,Sweetwater County,4738,54,60,18,4870
2000,11-17,Teton County,1501,3,5,9,1518
2000,11-17,Uinta County,2869,4,38,11,2922
2000,11-17,Washakie County,1007,5,11,8,1031
2000,11-17,Weston County,789,3,8,2,802
2002,11-17,Albany County,2102,45,39,36,2222
2002,11-17,Big Horn County,1337,6,18,7,1368
2002,11-17,Campbell County,4513,18,70,25,4626
2002,11-17,Carbon County,1489,16,19,16,1540
2002,11-17,Converse County,1468,12,16,7,1503
2002,11-17,Crook County,723,0,11,0,734
2002,11-17,Fremont County,2886,12,1217,15,4130
2002,11-17,Goshen County,1261,5,23,10,1299
2002,11-17,Hot Springs County,462,1,16,1,480
2002,11-17,Johnson County,736,0,4,1,741
2002,11-17,Laramie County,8017,279,97,103,8496
2002,11-17,Lincoln County,1950,11,13,7,1981
2002,11-17,Natrona County,6937,92,129,45,7203
2002,11-17,Niobrara County,240,1,0,0,241
2002,11-17,Park County,2686,11,20,20,2737
2002,11-17,Platte County,1014,5,9,3,1031
2002,11-17,Sheridan County,2764,13,74,25,2876
2002,11-17,Sublette County,661,2,4,3,670
2002,11-17,Sweetwater County,4301,55,61,20,4437
2002,11-17,Teton County,1555,4,8,11,1578
2002,11-17,Uinta County,2683,6,43,13,2745
2002,11-17,Washakie County,941,5,16,7,969
2002,11-17,Weston County,709,4,9,2,724
1992,11-17,Albany County,2398,25,37,37,2497
1992,11-17,Big Horn County,1364,0,6,3,1373
1992,11-17,Campbell County,4236,7,61,15,4319
1992,11-17,Carbon County,1994,7,6,7,2014
1992,11-17,Converse County,1530,3,20,3,1556
1992,11-17,Crook County,701,0,1,0,702
1992,11-17,Fremont County,3218,6,1022,7,4253
1992,11-17,Goshen County,1422,4,14,0,1440
1992,11-17,Hot Springs County,567,0,20,0,587
1992,11-17,Johnson County,711,0,9,1,721
1992,11-17,Laramie County,7645,294,83,100,8122
1992,11-17,Lincoln County,2049,2,14,0,2065
1992,11-17,Natrona County,6970,73,62,41,7146
1992,11-17,Niobrara County,260,0,0,0,260
1992,11-17,Park County,2668,4,14,11,2697
1992,11-17,Platte County,990,0,1,0,991
1992,11-17,Sheridan County,2762,5,28,15,2810
1992,11-17,Sublette County,586,0,0,0,586
1992,11-17,Sweetwater County,5476,44,53,22,5595
1992,11-17,Teton County,1066,2,9,4,1081
1992,11-17,Uinta County,3088,1,30,5,3124
1992,11-17,Washakie County,1065,0,14,2,1081
1992,11-17,Weston County,817,0,4,0,821
2007,11-17,Albany County,1914,59,33,44,2050
2007,11-17,Big Horn County,1232,12,12,2,1258
2007,11-17,Campbell County,4376,37,83,23,4519
2007,11-17,Carbon County,1281,9,27,12,1329
2007,11-17,Converse County,1372,26,18,2,1418
2007,11-17,Crook County,680,2,7,0,689
2007,11-17,Fremont County,2546,18,1207,17,3788
2007,11-17,Goshen County,1139,13,18,5,1175
2007,11-17,Hot Springs County,359,6,8,4,377
2007,11-17,Johnson County,768,6,6,3,783
2007,11-17,Laramie County,7751,321,133,130,8335
2007,11-17,Lincoln County,1866,15,21,5,1907
2007,11-17,Natrona County,6682,118,132,56,6988
2007,11-17,Niobrara County,202,1,0,2,205
2007,11-17,Park County,2372,21,28,20,2441
2007,11-17,Platte County,877,5,7,7,896
2007,11-17,Sheridan County,2409,21,77,15,2522
2007,11-17,Sublette County,781,6,13,4,804
2007,11-17,Sweetwater County,3907,66,67,35,4075
2007,11-17,Teton County,1506,9,14,24,1553
2007,11-17,Uinta County,2328,18,37,11,2394
2007,11-17,Washakie County,804,9,20,8,841
2007,11-17,Weston County,599,2,13,0,614
1991,11-17,Albany County,2314,19,35,37,2405
1991,11-17,Big Horn County,1324,0,6,4,1334
1991,11-17,Campbell County,4037,7,57,15,4116
1991,11-17,Carbon County,2008,7,6,9,2030
1991,11-17,Converse County,1481,2,19,3,1505
1991,11-17,Crook County,677,0,1,0,678
1991,11-17,Fremont County,3168,7,981,7,4163
1991,11-17,Goshen County,1405,0,13,0,1418
1991,11-17,Hot Springs County,546,0,18,0,564
1991,11-17,Johnson County,690,0,9,1,700
1991,11-17,Laramie County,7277,269,76,107,7729
1991,11-17,Lincoln County,1995,1,13,0,2009
1991,11-17,Natrona County,6757,60,54,40,6911
1991,11-17,Niobrara County,256,0,0,0,256
1991,11-17,Park County,2548,3,13,12,2576
1991,11-17,Platte County,974,0,1,0,975
1991,11-17,Sheridan County,2640,5,32,19,2696
1991,11-17,Sublette County,562,0,0,0,562
1991,11-17,Sweetwater County,5309,41,47,29,5426
1991,11-17,Teton County,989,1,10,4,1004
1991,11-17,Uinta County,2974,1,25,5,3005
1991,11-17,Washakie County,1057,0,10,3,1070
1991,11-17,Weston County,795,0,3,0,798
